写真	いい写真がないw|その写真とかあったはずだけど|集合写真は卒業生も？|おー、普通の写真|こういう写真はのりのりでとるのか...|おーひに写真初めて見せたら|卒業式の集合写真と|前のホテルの写真見せました！|めがねかけて写真とってみた！|なんの写真だろ？|普通にとても可愛い写真でした|写真見てて飽きないw|写真の共有ありがとう！|なんか上の写真と下の写真で|あと、おそめ結婚式の写真！|今日の写真もかわいいー|写真追加しようとしたけどわからなかった！|おとといのバンド練で撮った写真！|いつもすてきな写真ありがとう|写真共有ありがと|どの写真もさきちゃんかわいく映っててご満悦|写真共有ありがと！|いつのまに集合写真を...|どこの写真だろ？|あれ写真おくれない|写真とってー|写真もありがと！|写真たくさん|写真撮ったら送ってほしいな！
w	いい写真がないw|重いから無理かなと思ってましたw|そんなのあるんだーって思っていきつきましたw|おつかれさまw|さきちゃんの太股は大盛況だw|すごくw|商品はなんだろうw|ううむw|先生に不思議ちゃんに思われそうw|すごく適当です！w|うむ？w|俺はその規模は乗り気にならないw|懐かしさがあるw|ジャケット買ってよかった！ヒゲそってないけれどw|なの？w|しおんちゃん可愛そうにw|結構アクティブな人そうだw|さきちゃん家族も知ってるのねw|親父一人で行くのも変でしょうw|まちがえたw|あやのんがそれはかわいそうw|咲く時期はよさそうw|写真見てて飽きないw|なんか聞いたことあると思った！w|早めに寝ましょw|あれは千葉に来るのが緊張するってことだったんだろうかw|なんか訴えてるねw|次元っぽくはないw|いいです！w|明日結婚式でたくさん飲みそうだしw|すごいダイエットだw|過充電くらいだよ！w|へらへらしてたのw|腹筋と腕が筋肉痛でしたw|投げキッスかなと思って使ってみたw|巨人にみえる...w|そんな早くはムキムキにならないよ！w|早く起きようと思ったらいつも通りだったw|さきちゃん眠そうw|見てたというより打ってたw|バドミントンとなにしよw|そんなスタンプあったのw|俺入れただけでやってないw|良さげ！っておもって検索したw|ねむくなりそうw|お風呂はいってるのかとおもったw|思いつかないw|夜雪だるまつくったw|案外とおかったw|ご実家！うんうん、待ってもらわなくてよかったw|しおんちゃんは次のデートどうするかしか考えてなかったw|ただ中古でだいぶ昔のやつねw|いっぱつすごいw|偉い！のかなw|でも知らない店だったw|真イカは今日たべてないw|ふむふむ、とはいえなんかサイゼリヤで高級なのは飲む気がしないw|俺もなにもできてないw|ありがと！忘れたーって思ってたw
下	下はいやだ！|下が黒いズボン|なんか上の写真と下の写真で|下が切る前？
いや	下はいやだ！|仕事の最寄り駅からバスがいやだからだけど
上	上にしよう|なんか上の写真と下の写真で|上は後ろに流してるとかかな？|上は短い！|うん、ちょっと上にもちあげて|鍵の手前側だけ上にもちあげるかんじかなあ|上の会社が同じで俺の評価高いみたいだからがんばらねば|どんだけ上から目線だ！|上の標識見てれば大丈夫さ！
フォルダ	別フォルダに入ってるのかなあ
こっち	こっち使ってみましょ！|こっちのほうがいいかな、平年並みか少し早いか|こっちもついた！|こっちも雨だー|あれ、こっちは気温あがるみたいだよー|新しいブログ！こっち更新しようとおもいます|こっちからはかからないなあ|こっちは今はやんでるー|うん、こっちは曇りだから|こっちはいつも通り1115です！少し待ってて|おはよ！こっちは雨だー|さきちゃんこっちに来ますか？|日曜こっち雨みたいだから|こっち全然ゆれなかった|こっちはこれから晴れるみたいだから|こっちは見守るくらいしかないからね|こっちは順調です！|さきちゃんこっちにくるから|あら、こっちはかかってきてないよー|こっちは新小岩着くのは5時35分ごろです|こっちすごく質素|そしたらこっちの階段おりたとこにしよう
line	lineじゃなくて
ライン	ラインのほうがいいー？|ラインあるしどうなんだろうって|ラインよりかいい気がします！|ラインすら繋がらない|ラインが通話ちゅうになってた|ラインでかけるっ|ラインも送ったよ！|ラインのプレゼントありがと！
ー	ラインのほうがいいー？|おー！それは心強い|んー、普通にアプリ適当に探してたとき|そんなのあるんだーって思っていきつきましたw|新幹線乗れましたー|東京駅つきましたー|ただいまー|もう少しで仕事おえますー|疲れたー目いたいーもうパソコンみたくない|あ、さきちゃんも変わったー|親父が風呂あがったら風呂はいりますー|ほー|ばかもーん！|ただいま！ご飯たべるー|おー、普通の写真|うー、すごくねむい|風呂はいるー|ねますー、さきちゃん勉強？|俺もはみがきそのたー|俺は風呂入っておーひと食べいってきます|おーひと飲んでますっ|すかいぷいんしといてー|おーひに写真初めて見せたら|ほんとー、ちょっと二日酔いかも|おー、りきさく！|おー、がんばったね！|あんー？|うんー？|テストは大変だー、なんか思い出して|削除できたー|んーと|立派なケーキだー|うん、あがったらはなそー|もういっこのアウトレットいくー|うん、白かったー|ばあちゃんち寄ったりで疲れたー|着てみたら結構青色だー|おー？|んーん、伊勢の後松阪とか鈴鹿寄ろうかとか|さきちゃんいんしてー|ううー|おー、おめでと！|おー、はやい|すごい混んでたから仕事いくー|おー、あれ？|どうも提示には帰れなさそうだー|csiってなにー？|さきちゃんに言われたときすぐ薬のむんだったー|また痛くなるかもしれないー|おーひと飲みにいってきます|おーひがうちにきます！|せーらーじゅぴたー！|さきちゃんいつでもはなそー|おー、どうでしょう！|普通の病院もあるでしょー？|やったー！|運命の糸を　たちきいってそのさきにー|たちきいったそのさきにー|子供いそうってどんな顔ですかー！？って|明日はなそー|すこしはなそー|俺も好きー|俺あがったからいつでもかけてー|清潔感がありすぎー！|俺もあがったから11時くらいにはなそー？|何買ったのー？|今日もはなそー|今週最後がんばろー|承太郎そこまで身につけたらもう無敵じゃないですかー！|こっちも雨だー|風呂あがったー|残業だー|よねおーひが電話に出なくて外で待ちぼうけ|うん、明日はなそー|さきちゃんかけてー|営業の人とご飯食べてたー|さきちゃん今日もはなそー|栄光の架け橋へとー|さきちゃんあがったらかけてー|道が混んでて運転疲れたー|俺部活すぐ辞めてーだから後輩の接し方|少しはなそー？|みたことあるー|おいしそうだー|dvd返しに行ってたー|風呂に入りますー|スカイプかけてー|いってきます！バス遅れて遅刻ー|今片づけ50％くらいだー|おー！みじかい！|寝過ぎましたー|面談終わったー|おー、やったね|んー、面談が落とされるのと|俺だけ落とされましたー|歩き疲れたー|おなかはちきれるー|助川さんと須藤さんと飲んでたー|Skypeかからないー|うん、がんばろー|金曜のりきろー|ばあちゃんとご飯食べてお腹いっぱいー|新しい職場の人と飲んでましたー|新しい現場のー|俺も大好きー|んー？|さきちゃん今日ははなそー|今日の写真もかわいいー|ふろはいるー|いい指導者さんだー|んー、帰らなさそう|いまおきたー|さきちゃんサッカー見ながらはなそー|かけてみてー|うん、適度にがんばろー|がんばろー|まだかかるー|のんでかえるー|おはよ！ふらふらー|今日はぐだぐだでしたー|ただいま！ふろはいるー|来週かー|まってるー|雨だー|了解！予約しちゃうー|まだかえれないー|ご飯食べて帰るー|おー、聞いたことある方言だと思います|俺は調子微妙だー|今日も疲れすぎたのでジム行かずに帰るー|ほほー|新幹線乗りましたー|おー、さきちゃん共有ありがとう|まだかいしゃー|こっちは今はやんでるー|しゃわーあびる！|んーと10時くらい？|片づけしてるからかけてー|延長戦だー|いってきますー|あれ、今日だったんだー|ふろあがったー|今日も明日も仕事ー|うん、ありがとー|俺も好きー！|徹夜ですー|ねむくなってきたー|風呂上がった！はなそー|風呂入るー|ただいま！風呂はいるー|おー、楽しかった？|おー、気合いはいってる！|ただいま！はなそー|ちゅー！|なんでー|おー、良かった！俺も座れました|俺もしゃわー|食べ終わったはなそー|俺も寝るー|しゃわー|昨日もさきちゃん可愛かったー|ただいま！しゃわーあびた|もうかえりたいー|今日も10時までー|伊勢11℃になってたー|おはようふろー|おつかれさまでした。ゆっくり休みましょー|ねむいー|8000円がぱーになった|おはよ！こっちは雨だー|他のメンバーもしーんとなっちゃって|今日はなそー？|ついったー|おれもー|風呂入る！目が疲れたー|びとうぃーんの船橋6ど！|さま！目がつかれたー|うん、つかれたー|ぼじょれー！|あめふってるー|12時すぎに帰るー|かけていいー？|ありがとー|風邪で休んでるー、あんまりよくならない|喉腫れてますねー、次ーって感じで|買って帰るー、買うのもしんどい|帰ったらはなそー？|かけてもいいー？|自社の人俺一人だから居心地悪いー|夏見北でーす、先でとまりまーすぅ|ううん、停留所の10めーとる先くらいでとまったよ！|どうも電波悪い。今日はねときましょー|りあるすこーぷ|はなそー|うん、かけてー|今日も痛いー|おかえり！風呂あがったー|電気ガス水道おっけーです|やってたんだー|おめでとー！！|おー、あとは宅急便で送ればいいだけかな？|いまからかえりますー|今日も9時頃目安でかえりますー|おー、よかった|じゅうでんきれる！まっててー|おおー、となると母親の誕生会とやらに|歯医者は3時からー。いすと机はきたけどまだルーターがきてない|おつかれさまー|眠たかったー|20分ごろかえりますー|8時15分ごろ帰りますー|おかえりご飯食べてジムいきましょー|おつかれさま！9時頃かえりますー|おーひが新小岩にくるようなので晩ごはん一緒にたべよ|おーひ来ます|しおんちゃんと飲んでるー|帰ったらはなそー|新小岩何分だろー？|さきちゃんはやー|がんばろー！|お昼たべてないー|すてーき！|アイス買ってかえるー|今日もあめー|写真とってー|まだだるだるー|うどんなら食べれそうだーと思って|100きんよってかえるー|しゅーらるーしらない|すこし残業して帰るー|んー？なんでまた？|キャンセルはしておくから、さきちゃん予約してみてー|おつかれさま！めずらしいー|8時過ぎにかえりますー|そうしましょうかー|帰ります！たぶん10時すぎー|しんこいわー|かえりますー|駅までこれるー？|もうつくー|帰ります！11時ぐらいー|おつかれさま！今日も昨日と同じくらいー|くったーな|はい！ほか弁かってかえるー|さきちゃんおきたー？|帰ります！8時半くらいー|そんな遅くならないようにするー|帰ります！10時すぎー|何時までー？|今日からまた少し遅くなりそうー|それはたのしみ！だけどあんまり集まりたいと思わないー|まだあがれなさそー|おれもといれー|おきてたー|7時40分くらいー|8時半にはあがりたいー|総武線とまりまくりで萎えー|さきちゃんまだぎんこういるー？|帰ります！45分くらいー|はすきー！|おそくなりそー|おーひが飲み足りないみたいだけど|帰りますー|ご飯食べてかえりますー|さきちゃんいくならいくー|次しんこいわー|かなりある！よかったー|寝てたー|少しまっててー|もー場フォンさいれんともーど|今日は10時出社だったので、もう少しやって帰りますー|しおん氏体調不良で帰りますー|今日も送別会なくなったから普通に帰るー|おつかれさま！今日はもう少しやって帰りますー|いいのなかったー|おつかれさま！帰るー|今帰ったー|それくらいで！米かおー|今日はなんかまったくやる気がしないー|もうすこしがんばろー|がっつり食べるぞー！なら牛角のクーポンがよさそうだけど|次錦糸町ー|じょーすたー！|はやくかえろー|かえるー|たべいくー？|おー結婚式だ！|ほおー|あらいつのまにー|さきちゃん封筒ありがとー。申し込み書出せました！|おつかれさま！かえりますー|まだ6時台かー、ってくらい残業慣れしてしまってます|おつかれさま！かえってますー|もう少しやってかえりますー|俺もサミットいくー|やすーい|かえるー！|南口いくー|あ、北いくー|あがった！11時はすぎますー|かえりたーい|10時頃にはあがる予定！えんまるにでもいこー|はよ帰りたいー|軽くが少し長くなったー|かえります！11時過ぎくらいー|俺は5月2か6休めそうー|後半休み合ったらいこー|今日も遅くなりそうだけどえんまるにでもいこー|いまからでるー|あったんだー|特にやること無かったから帰るー|墨田のほういってくるー|ほー、祝日だからすいてるのかな|よねとおーひと飲みに行くかも|帰社しますー|帰ってますー|負けたー|ぎりぎりそうだから新小岩で待ち合わせましょー|同僚に飲みのお誘い受けたのでいってきますー|きいてみるー|買い物できたー？|俺のほうがはやーい|すこしおそくなりそー|おー、きれいに書いてもらいましたね|ジムいくことにするー|届けられるけどどこー？|おーひ、よね、おそめと飲んでます|あきばのブックカフェきたー|おー、また一緒に見よう|そっちいってたんだー|ボーナスもらえないってさー|職場見学とやらいってきましたー|雷もすごかったー|おつかれさま！メールするー|久々に働くと疲れるー|ほー、どこいこうか？|内宮今出たので、ららぱーく5時とかかなあ|ららぱーく後17:45までバス無いから|今からららぱーく向かいます|ららぱーくから大湊行くバスが17:45までありません|ららぱーく|ららぱーくまできてもらえると|おつかれさま！ちょっと残業しましたー|今日は少し残業しますー|おつかれさま！かえるー|ほー、そしたらどこでご飯食べよう？|直前になっちゃったけど、おーひよねと飲みいってくるね|おー！ありがとう|かえろー。雨はどうだろう？|30分ごろに駅いくー|ありがと！忘れたーって思ってたw|おーひの終電逃した|ほー、いってみようか|かえる！おつかれさまー|おつかれさま！もうそろそろあがりますー|おっけー！|んーむ|さきちゃん映画見終わったー？|一緒にかこー|ほー？|ティッシュこうてきてー|松屋は持ち帰り味噌汁つかないからー|つらいー|おー、いい感じのシフト|かえれないー|北口着いたらおしえてー|おーひ！|はい！おつかれさまー|ぽにー|かえってますー|さきちゃんも残業なかったら一緒にいこー|おー！かえりますねー|おつかれさま！俺の方がはやかったー|はい！俺もそろそろ出るから同じくらいかもー|少し残りますー|おつかれさまー。図書館で勉強してますね|いけますー？|よかったー！|わかりました！ありがとー|午後もがんばるー😎|さきちゃんどうだろー？|帰ったらみせてー|おーひ彼女は同い年だった|雨は降ってなさそうだから早く帰るー|らーめん食べて帰りました！|ほかべんにするー|俺はおーひとご飯いてきますねー|今かけてみたー|交換しましょー|何か食べに行こー😔|もういれたー|人気店だったんだー|おつかれさま！やったー|あと1時間は残りそうー|午前終わりました！午後もがんばりますー|イベントステーションの前にいるー|指輪わすれたー|おー、きれい|よかったー|おー、やったね！|昨日ペルソナ5買ったんだー！|一緒にのってこー|キングダム読みながら帰りますー|飲み会ですー|もう飲まないー
デート	デートの時間かえました|またデートしよう|ほのぼのデート|次の男とデートするに感じて|しおんちゃんは次のデートどうするかしか考えてなかったw|2回デート行って、付き合ってみる？とかいって拒否されたみたい
さき	さきちゃんスタンプ取れたんだ|さきちゃんの太股は大盛況だw|さきちゃんおはよう|さきちゃんは乗れたかな！|さきちゃんおやすみo|さきちゃんはどう？|さきちゃん好き！|さきちゃん明日テスト？|いってきます！さきちゃんいってらっしゃい|あ、さきちゃんも変わったー|さきちゃんもなかなかスーツ似合うようになった！|ねますー、さきちゃん勉強？|さきちゃんのティッシュとオレンジ？|さきちゃんもよく耐えた！|さきちゃん話せる？|さきちゃんこんにちは！|さきちゃん|またさきちゃんきたとき|さきちゃんこんばんは|なんかさきちゃんはささっと書いた方が|さきちゃんにはこんな感じで|さきちゃんテストはどうですか？|さきちゃんたいへんだ|さきちゃんいくの？|とはいえ、さきちゃん一人でも行ってほしくないので|さきちゃんの言うとおり|さきちゃん物知り！|いっぱいさきちゃんを撮ってもらおう！|さきちゃんおはよー|なんだか将来のさきちゃんを想像してしまった|さきちゃんそろそろかえります|さきちゃんがサバゲー∑|さきちゃん交通費浮くのかな|さきちゃん明日もテスト？|さきちゃんおはよう！|さきちゃんテストがんば|さきちゃん家族も知ってるのねw|さきちゃんも最後がんば|さきちゃん帰ったらはなそ！|さきはカラオケだれといったん？|早く帰ってさきちゃんと話したい|さきちゃんはなそっ|今日は寒いねさきちゃん|服、雑誌、ゲーム、さきちゃんのプレゼント！|さきちゃんスカイプインしとくね|さきちゃんの昨日の谷間が|さきちゃんの顔うつってるので|さきちゃんありがとっ|さきちゃんねます？|さきちゃん11時半くらいにはなそっ|さきちゃん少しはなせるかなー|　さきちゃんおはよー|さきちゃんさきちゃん|さきちゃん3度寝しちゃったん！ショック！|あら、さきちゃんも早起き！|さきちゃんのほうにも反映されるのか！|さきちゃんは明日から学校がんば|さきちゃん勉強がんばって！おやすみっ|さきちゃん学校おつかれさま！|さきちゃん今日は話せる？|さきちゃん髪切った？|さきちゃん一番右！|さきちゃん勉強進んでますか|さきちゃんに言われたときすぐ薬のむんだったー|さきちゃんまだ寝なくても大丈夫？|さきちゃんおやすみ！|さきちゃんのハートマーク許せません！|さきちゃんキルラキル見終わったよ|さきちゃんはなせるかな？|さきちゃん酔ってたからね|来年はさきちゃんと都内に近いとこに引っ越しましょう|となると、さきちゃん5月会う日は日月だけど|さきちゃん今日もはなそ|あれ、さきちゃん|さきちゃんおやすみ|さきちゃん！|さきちゃんほめて！|運命の糸を　たちきいってそのさきにー|たちきいったそのさきにー|さきちゃんの声ききたいです|酔っててもさきちゃんのまえくらいです|さきちゃんの前でも体制をたもちます|さきちゃんこんばんは！|さきちゃん今日はお勉強？|さきちゃん寝不足そうだから早めに|さきちゃんただいま！|さきちゃんバイトがんば|さきちゃん何食べる？|さきちゃん今日もはなそっ|さきちゃんはいつごろだろう？|さきちゃんバイトは火日？|さきちゃん今日も一段と可愛かった！|さきちゃん今日は寒いよ！最悪！|さきちゃん帰ったらはなそっ|さきちゃん1130頃はな|さきちゃんただいま|さきちゃん5月は|さきちゃん少しはなそっ|さきおはよう！|さきちゃんかけてー|さきちゃん今日もはなそー|さきちゃんにすごい辛いこと言われた？夢をみたよ|さきちゃんあがったらかけてー|さきちゃんバイトおつかれさま|さきちゃんもう寝ちゃう∑|さきちゃん今日早いね|さきちゃんは明日もテストだよね|俺は9時頃帰りかな、さきちゃんおかえり|うん！さきちゃんもテストがんばってね|さきちゃんbetweenのトップの画像変えられるかな？|さきちゃんにチークがつきましたね|さきちゃんバイトおつかれさま！|ナースさきちゃんあげる！|さきちゃんと住む場所探し中！|さきちゃんいってらっしゃい|さきちゃん史上一番みじかい|さきちゃんセンスで変えちゃってもいいよ！|さきちゃんがインしました|メリットもありますね！さすがさきちゃん|さきちゃんありがと|愚痴でした！さきちゃんありがと|さきちゃんがんばったね|俺もさきちゃん好き|さきちゃんは|さきちゃんおやすみ？|さきちゃんと住むとこね|さきちゃん話せそう？|さきちゃん誕生日おめでと|さきちゃん今日ははなそー|さきちゃん昨日も可愛かった！|さきちゃんサッカー見ながらはなそー|月曜は疲れるねさきちゃんおやすみ！|さきちゃん5日予約して大丈夫？|うん、さきちゃんおやすみ|さきちゃんもうすぐ帰ります|さきちゃん学校いってらっしゃい|さきちゃんかけていい？|さきちゃんの応援してたカメルーン、イングランドはもういません|さきちゃんかけて！|さき先輩だね|さきちゃんまた明日|おー、さきちゃん共有ありがとう|さきちゃんバイトいってらっしゃい|さきちゃんバイトお疲れさま！|さきちゃんさっぱり！|さきちゃんねちゃう？|さきちゃんになにしてもらおうかな|さきちゃん今日ははなせる？|さきちゃんあと2日がんばろ|さきちゃんのほうがおそい|さすがさきちゃん！|さきちゃん10日のバイト？|さきちゃん話せるかな？|左下がさきちゃん！|まんなかさきちゃん！|さきちゃん明日話そう|さきちゃん天気予報的に|さきちゃんかわいい|さきちゃんいつも通り着きそう？|さきちゃん電話しちゃってた？|さきちゃんのFacebookは見れない|さきちゃん眠そうw|さきちゃんもいってらっしゃい|さきちゃんおやすみ！またはなそ|うん！さきちゃんいってらっしゃい|ただいま！さきちゃん無双ができるね|なにしようかねさきちゃん！|さきちゃんいってらっしゃい！|さきちゃんねます！|おつかれさま！さすがさきちゃん|さきちゃんかけてっ|さきちゃん夜もはなそっ|さきちゃんお出かけ？|さきちゃん掃除中はなそっ|さきちゃん緑好き|今日は前にさきちゃんに会ったときなみ|さきちゃんごめんね、遅くなりました|昨日もさきちゃん可愛かったー|さきちゃんほんにありがとう！|さきちゃんは病院いけた？|昨日のさきちゃんも可愛かった|今日のさきちゃんも可愛いかなっ|さきちゃんもよく寝て明日いっぱいいちゃつこ！|さきちゃんは新しい実習はどうですか？|さきちゃんは可愛い！|さきちゃんおきてて|さきちゃんイリーナ、俺レノにしよう|さきちゃんこっちに来ますか？|さきちゃん口座教えて|さきちゃんお菓子楽しみだけど|よく撮れてます、さすがさきちゃん|さきちゃんは親子丼！|いってきます、さきちゃんもいってらっしゃい|さきちゃんカイロ！|さきちゃんと見たかったけど|さきちゃんそういえば|さきちゃんあと少しがんばろ|さきちゃん明日来れそう？|さきちゃん入れた？|はいさきちゃん|さきちゃんおきてる|さきちゃんどこいくの|さきちゃんペガサス|さきちゃんは正月なにしてる？|相続は大変だねえ、さきちゃん|さきちゃんもびっくり|さきちゃんに会えるのが楽しみ|どの写真もさきちゃんかわいく映っててご満悦|さきちゃんありがと！|さきちゃんも頑張りました|さきちゃん早寝|さきちゃん内定取れてるよって伝えたよ|さきちゃん13日夜に来れそう？|さきちゃんとチャットできたから頑張れる気がする！|さきちゃんなにか言われたな！|さきちゃん悪くない！|俺もさきちゃん好き！|さきちゃんはどこだろ？|さきちゃん今日もはなそ！|さきちゃん、ロキソニン飲んだから歯痛どころか|さきちゃんこっちにくるから|さきちゃん買い出し気をつけてね|さきちゃんはなそ！|さきちゃん見知らぬ電話番号からかかってきたから|あら、さきちゃん行動力ある！|さきちゃんご飯食べた？|さきちゃんはやー|さきちゃん南口で！|さきちゃんまってて|さきちゃん終わったら教えてね|さきにかえってていいよ！|さすがさきちゃん|さきちゃんありがとう！|そういえばさきちゃん今日休みだったね|さきちゃんより早く帰ります！|うーん、月曜夜とか？さきちゃんの都合いい時間で渡してもらえばいいかな|さきちゃんだけ渡してもらっておくとか|さきにご飯食べておいて|お金振り込みたいのでさきちゃん駅これる？|さきちゃんハッピーアワーいってみたい|一応親用のメールさきちゃんにも出しました|どれがいいか決めかねる！さきちゃんはどれがいいと思う？|キャンセルはしておくから、さきちゃん予約してみてー|駅→着付けのとこ→さきちゃんちと回ってもらうかと|さきちゃんちに行ってなにすればいいのか|さきちゃん食べたでしょ？|さきちゃんおきたー？|さきちゃん新小岩何時になりそう？|俺家いるけどさきちゃん帰ってない！|さきちゃんいくならいくー|さきちゃんにあわせます！|さきちゃん封筒ありがとー。申し込み書出せました！|さきちゃんもがんばりましたね|なぜかさきちゃんが船橋市いることになってる|さきちゃん的によさげなやつで！|さきちゃん戻るまではいるよー|ルノアールおります！さきちゃん来る？|さきちゃんが解放された！|ハイパーアクティブさきちゃんですね！|さきちゃんのほうが早そうだ|さきちゃんでいいよー|さきちゃんはまだか！|さきちゃんもどうぞ|作れれば！さきちゃん食べた？|さきちゃん傘ある？|普通に帰ることにします。さきちゃんごゆっくり|さきちゃんの成長をひしひしと感じます|さきちゃん映画見終わったー？|さきに寝てて|さきちゃんいつごろ来るかな？|さきちゃんも一緒にいきましょ|さきちゃんも残業なかったら一緒にいこー|さきちゃんクリーニングのカード持ってたっけ|あああ、さすがさきちゃん|さきちゃんどうだろー？|俺とさきちゃんは全額免除対象になれるらしい|はい！さきちゃんも台風気を付けてね|大勢！さきちゃん、ゆうすけさん、両親、こうすけさんち、まさしさん|さきちゃんの手料理が恋しい！|お給料ふりこまれた！さきちゃんの口座番号と支店なんだろ？|なんか認証中とかかもしれないから、さきちゃんは買わないでおいて|今月のお給料入ったので、さきちゃん口座に振り込みました。|さきちゃんは大丈夫？|さきちゃん終わったらフルーツパーラーいこ
スタンプ	さきちゃんスタンプ取れたんだ|あれそんなスタンプあったっけ|新しいスタンプですね|アプデでスタンプふえた！|なんというスタンプ|そんなスタンプあったのw|新しいスタンプ|スタンプかったことない|あれ、見覚えのないスタンプ
無理	重いから無理かなと思ってましたw|無理ゲーです！|無理しないでね！|無理でした！|無理！
それ	おー！それは心強い|それは心強い！|それですそれです|あやのんがそれはかわいそうw|船橋から直通の出てるからそれ乗れば|残業してそれでも終わらないなら|それはいいことです|それは田中さんかな！|それが今の生きる糧だから|それないいことなんだろうか！|それは|それもあるプラス旦那が姉としか話さない|それはとてもいいね！|それはなにより！|それはいいこと！|それはびっくり|それ！|俺もそれまでに済ませちゃう|それはまた難しいね|それくらい|それまで一緒にいよう！|いつもは宿込みだとそれ以上！|それくらいなら大丈夫|それはもちろん！|うん、それくらいにいこう！|それはみたことあるっ|薬もらってそれ飲めばよくなるはずっ|それは事案ではありませんか！|それは気持ち悪い|それまでの辛抱|それくらいにいきます！|それはたのしみ！|それはいいかも？|それでいいといったけど、家にはあげません！|それか指輪取りに行ったあと、夕方くらいから横浜とか|それは良かった|それはたのしみ！だけどあんまり集まりたいと思わないー|それくらいで！米かおー|それくらいするもんなんだ|それはいけません！|それはすごい|それだ！|俺もそれくらい！今ひらい|それは透けそう|それは俺のかな？探したけどなくてね|俺もそれに乗ろう！|それは残念。家いますね！|それとは関係なく書った本読みに外出ました！
カップル	カップルの特権アプリ...|カップル専用みたいなのあって|美術館カップルイベントやってるみたい
特権	カップルの特権アプリ...
アプリ	カップルの特権アプリ...|んー、普通にアプリ適当に探してたとき|アプリは簡単な画面作れるようになった！
...	カップルの特権アプリ...|いつの間にか11時半...寝ようっ|こういう写真はのりのりでとるのか...|ぱちお氏は順調にうまくなっている...|寒かったけどなんとか胸痛くならずすみました...|もうすぐ...|白のズボン買うべきか悩む...|帰れない...|たぶんこれインストールすればいけると思う...|似てる...|なんで正社員なのに就活みたいなことしてるんだろう...|巨人にみえる...w|土曜は中止になりそうですね...|自転車の鍵なくした...|Gが出ました...ブラックキャップ買いにいきます|いつのまに集合写真を...|今日寝られなさそうなくらい...|朝方親からメールきてたような...|もう8時か...|一度言い出したら自分の意見が通るまで言い続ける人だからなあ...|チームメンバーが一人もいなくて仕事が全く進まない状態...|ううむ...心配ですね|すごい...|今日は暖かくて心落ち着く...|今日も遅くなりそうです...進みがとてもわるい|2万円...高くはないと思います|まだ帰れぬ...|ホームまであがれない...|あ、洗濯物ほしてない...|眠たい...風呂入ってねよう😌|ぎりぎり座れた...17:27着予定です|改善の余地がありますね...
普通	んー、普通にアプリ適当に探してたとき|縄がソフトだったし、普通痛くないみたいだよー|おー、普通の写真|普通でいいですw|普通にとても可愛い写真でした|普通の盆栽ほしい！|おお、普通のナース服！ってかんじ|普通の病院もあるでしょー？|男の脂肪は普通預金、女の脂肪は定期預金だって|こちらなんだかんだ遅れなしで普通に空いてました|普通の電車遅延で少し遅刻した！|もうぷらっとこだま買わないで普通に自由席買った方が|普通にいいカフェだし人気でそう|普通にしないで全クリしちゃいました|今日も送別会なくなったから普通に帰るー|普通に遅くなりそう|普通に帰ることにします。さきちゃんごゆっくり|普通に降ってるね！
適当	んー、普通にアプリ適当に探してたとき|すごく適当です！w
専用	カップル専用みたいなのあって
STICKER	STICKER
こいつ	こいつ動くぞ！
歯磨き	歯磨きしたら話せますっ|歯磨きしてインするねっ|歯磨きしても12時にははなせます|うん！歯磨きしてくる
たい	たいがくんとたけるくんだ|たいがくんか！|たいがくんもたけるくんも悲しみそうだ
太股	さきちゃんの太股は大盛況だw
盛況	さきちゃんの太股は大盛況だw|おお、大盛況
寝心地	寝心地は最高です！
最高	寝心地は最高です！|しおんちゃんは嫁にするなら最高だね！と|この時間で12℃あって最高16℃
ょっ	寝る前少し話しましょっ
準備	ちょっとあしたの準備しますっ|準備おわった！|明日の準備！|もうすぐで準備できる！|しっかり準備だね！|寝る準備しちゃう！|寝る準備できたら連絡するね|おお、準備ばっちり！|やっぱり出る準備できたらかけます！
新幹線	新幹線乗れましたー|新幹線乗りましたー|新幹線も満員|雪降ってて新幹線遅れてるから|あ、まだ新幹線代入れてないからご飯食べたらふりこんどきますっ|新幹線にコンセントあるはず！|8時開店で買えた！新幹線も乗れて定刻通り
勉強	勉強俺もする！|勉強がんばっ|ねますー、さきちゃん勉強？|あんまり勉強しなかったけどね！|うんうん、勉強がんば|さきちゃん勉強がんばって！おやすみっ|掃除してた！勉強するっ|さきちゃん勉強進んでますか|さきちゃん今日はお勉強？|大変そうだけどいろいろ勉強にもなりそうかな|勉強がんばって|俺はルノアールで勉強中|喫茶店で勉強してたから戻ります！|お勉強する|もう少しルノアールで勉強して帰りますね|図書館で勉強してます。8時ごろに帰ります|おつかれさまー。図書館で勉強してますね|アキバにパソコン見に行ってお勉強
俺	勉強俺もする！|俺もあがってふとん！|俺もはみがきそのたー|俺は風呂入っておーひと食べいってきます|うんうん、俺には似てないと思うけど！|筋トレ終わったので俺も考え事します|俺はその規模は乗り気にならないw|俺は来年冬を乗り切るために考えます|俺ももうねよー|おそらく俺の希望メインになるかと！|俺も好きだよー|俺も今帰ったとこ|俺もまた伊勢いきたいです！|俺は太ってきましたよ！|俺はないよ|俺もあと1時間くらいやって帰ります|俺もどうしよー|俺も|お、俺の日課が復活します|俺ものれたよー|俺もぼけっとしときます|うん！俺朝入ったからいいや|俺はだれだろ、北関東の猿が好きかな！|俺もスカイプインしてるね|俺はちゃんとわきまえてよいますよ|俺がおそくなりました|俺も好きー|俺あがったからいつでもかけてー|俺はスーパーで弁当でも買ってかえろうかな|俺もあがったから11時くらいにはなそー？|俺も大好き|ううん、俺も怒っちゃってごめんね|俺も6部まで読んでる！|俺も好き|ん、俺も軽くあびてくるから|俺今からっ|俺は10時くらいに帰るから10時半くらいになるかなっ|俺は9時半くらいに帰るね|俺映ってるのはまた送ってくれるんじゃないかなあ|俺部活すぐ辞めてーだから後輩の接し方|うん、俺も楽しかったよ|俺は9時頃帰りかな、さきちゃんおかえり|俺もあがった|俺もたぶん減ってるな！|俺は今電車内でがんばってます！|俺はもう治ったかな|俺だけ落とされましたー|俺もさきちゃん好き|俺も寿司食べる！|俺も風呂あがった！|俺はいつでも話せる！インしてるね|俺も大好きー|俺はもう話せるからスカイプインしとくね|やったね！俺も鍛えねばっ|俺は調子微妙だー|俺の応援してるドイツベルギーはベスト8残ってます|俺は出れないからさらに遅れちゃう|俺はもう寝るねー|俺のグラスじゃないよ！|俺も昼にラーメンたべた！|俺はねますっ|俺も好きー！|俺もそれまでに済ませちゃう|俺も名古屋ついた！|いいえ！俺も楽しかったよー|俺が説得する！|いえいえ！俺は食べてないけどおいしいといいけれど|明日は俺が待てるようにしたいっ|おお、俺はちょっと早めに着くかな|俺もちょっと東京でゆっくりしてたから|おー、良かった！俺も座れました|俺もしゃわー|俺は茶色好き|俺も寝るー|俺もすき|どうも現場で俺が辞めたがってると噂されてて|俺もはいる！|俺もでました|うん、俺も寝る|残ってるの俺だけだった|俺いつでも話せるからかけて|俺入れただけでやってないw|俺は寝ます|俺は明日に備えて、帰社日欠席でかえる！|俺も3連休！なにしようか|俺もしおんちゃんとのんでかえる！|俺どんなコスプレ似合いますかねえ！？って聞いたんだけど|俺はレオ？でいいんじゃみたいな|俺こんなかっこよくない|さきちゃんイリーナ、俺レノにしよう|俺もはやとちりでごめんね|俺ももう少しであがれる！|俺は八重洲口ついた！|ううん、俺も武将討ち取るのに忙しかったから|俺は帰社日なので遅くなりそうだから|俺も風呂はいるっ|俺が先導します|俺も大好き！！|すごくいいね！俺より年収高い|今日は俺定時にあがる予定だから|俺頑張ってやってるけど|俺の方が早く帰る可能性|ちなみに俺は1936到着予定|俺はついたよ！昨日のとこいるね|上の会社が同じで俺の評価高いみたいだからがんばらねば|俺も占えたの！|俺はばあちゃんちから今帰ってます|よかった！俺も乗れた|俺は船橋についたよー|俺も好きっ|ヒーローものなんだ俺はいつでも話せます！|俺も風呂はいる！|俺もさきちゃん好き！|自社の人俺一人だから居心地悪いー|俺は50分新小岩くらいだからさきちゃんもちょうどいいかな？|俺もいかなきゃ！場所教えてね|俺11時5分くらいに新小岩着です|俺は8時半くらいかな|よかった！たぶん俺の方がはやそうだから|おつかれさま！俺は830すぎです|俺の方がはやいかも？|俺もほかべん買って食べてるよ|俺寝てて歯医者いけなかった|俺は今日は遅くならなさそうだから|俺は7時半には帰るよー|今ららぽーといるから俺の方が遅くなるかな|たぶん俺620に新小岩くらい！|俺は7時には帰れる|俺は1時半に出る感じ|俺聞いてみるよ|俺ももうあがります！|俺は8時40分頃かえる！|あ、でも俺が戸籍謄本もらいに行くとき一緒にもらえばいいや|俺も帰る|俺はルノアールで勉強中|俺は11時目安に帰宅かなー|俺はそろそろあがりたいけどどうなるか微妙|俺は今日は終電近くになるかなあ|俺23時ぐらいに新小岩|俺の方が早そうだったら美容院までむかえにいくね|おはよ！俺は8時10ごろ帰宅よていです|俺もトイレいきます|はい！俺は食べにいこうかなあ|俺も帰宅中|俺両国でご飯食べるから同じくらいかも！|今気づいたの！俺使ってたのに|俺も寝ます！|俺は今飯田橋|俺家いるけどさきちゃん帰ってない！|俺はたぶん55分新小岩とか|俺は帰ります！|俺もいくよー|俺はそのままいくね！|俺は15分後くらいに帰るね|俺も今帰り途中|俺はしおんさんとかと飲みに行ってくるので|俺もなにもできてないw|俺もサミットいくー|俺は5月2か6休めそうー|俺も行く！|俺各停です！|俺のほうがはやーい|俺もそのころ家戻るよー|俺もいく！どこにいく？|帰ります！俺の方が早そう|あら、俺の方が早いかも？|俺はなくならないよ！|おつかれさま！俺も今から帰ります！|俺もそれくらい！今ひらい|俺も電車乗れたけどゆっくり|俺は明日も休みだし起きてると思うよー|俺もお茶しに行く！|俺もお茶の水のりかえで20分くらいでいけそうだけど|はい！俺はもう帰ってご飯たべたよー|俺もここよくわからない|俺のほうがはやいかなー|俺も残業中|俺も帰ります！|カード俺持ってます|俺も休むのでわかったら教えてね|俺はたぶん新小岩7時45分くらいかと|おつかれさま！俺の方がはやかったー|それは俺のかな？探したけどなくてね|はい！俺もそろそろ出るから同じくらいかもー|俺もそれに乗ろう！|俺も乗ったけど混んでて探せなさそう|おつかれさま！図書館いたので俺も帰りますねー|帰りましたが、お兄さんとお話し中のようですが俺がいること悟られないようお願いします！|俺とさきちゃんは全額免除対象になれるらしい|お、なら俺も食べないでまってよー|俺はおーひとご飯いてきますねー|俺も2,3分遅れてつきそう！|俺もいこ～|俺次平井！|俺が寄るならお茶でも出すよっていったの|俺はもうお昼はすませてるねー
金	金時計でいいかな？|金時計いくね|金時計の前にいるね|のぞみ乗ったのでいつも通りで金時計
時計	金時計でいいかな？|金時計いくね|金時計の前にいるね|のぞみ乗ったのでいつも通りで金時計|2階の時計コーナー移動します
おれ	ん！おれはもうちょっとだから|うんおれも|おれもきがえよう|おれもついた！|おれもー|おれもといれー
銀	やっぱり銀のほうがいいかな？
きち	さきちゃんおつかれさま|ん、さきちゃんおやすみっo|さきちゃんおはよっ|さきちゃんおやすみっ|さきちゃんおはよ|さきちゃんおつかれさま！|さきちゃんおはよおお|さきちゃんいんしてない|さきちゃんいんしてー|さきちゃんおはよ！|さきちゃんおでかけ？|さきちゃんいつでもはなそー|さきちゃんはなせるかなっ|さきちゃんおはよおおおお|さきちゃんばっちり！|さきちゃんただいまっ|さきちゃんもおつかれさま！|さきちゃんおつかれさまあ|さきちゃんそろそろおつかれさま！|さきちゃんすかいぷいんできそう？|さきちゃんおはよよよ|さきちゃんつうわちゅう|さきちゃんいんしてないようにみえる|さきちゃんといっぱいいちゃつけるように|さきちゃんおはようれ|さきちゃんはなせるときはなそっ|さきちゃんおつかれさまっ|さきちゃんあとではなそっ|さきちゃんおつけれさまさま！|さきちゃんいんしたらかける！|さきちゃんぽじてぃぶ！|さきちゃんねちゃうる|さきちゃんおはよ？|さきちゃんもおつかれさまっ|ポストにでも鍵入れとくか、さきちゃんだいぶゆっくりめで|さきちゃんおきてますかっ|俺は50分新小岩くらいだからさきちゃんもちょうどいいかな？|さきちゃんどこいってんだろ？|あるとしたらご飯食べる前10時にさきちゃんち行って|さきちゃんまだぎんこういるー？|えんまる、ぼかろか、うめきち、とんこいわ、ヴあまんま、はいから、|さきちゃんまだいたらいくね|さきちゃんのほうどうじゃろ？|あとバスタオル白色なかったので、さきちゃんちあるかなあ
ゃんおつかれさま	さきちゃんおつかれさま|さきちゃんおつかれさま！
東京	東京駅つきましたー|東京も京都も明日かあさってじゃないかな|都営新宿か東京メトロ東西線|東京ついた！|俺もちょっと東京でゆっくりしてたから|明日は東京6時で！|東京駅むかう|東京ちょっと遠回りになるから|東京都葛飾区西新小岩1丁目4-1|おはよ！7時半東京目安でお願い|東京涼しいけど、明日天気いいといいね
風呂	風呂入ってねます！|風呂あがった！|親父が風呂あがったら風呂はいりますー|風呂はいるー|俺は風呂入っておーひと食べいってきます|風呂っ|風呂はいる|お風呂？|風呂はいります！|風呂入る！|今日はもう寝て、明日風呂入ります！|なんか風呂入る気がしなくて|かえって風呂入ったよ！|風呂入るので少々おまちください|風呂はいりますっ|風呂あがったー|風呂入ってすぐねよー|風呂あがりました|風呂入ってねよー|風呂入ります！|風呂あがったら話せるかな？|風呂に入って1030とか、11時かな|遅くなると風呂入りたくなるよ|風呂入って1130くらいに|風呂入って寝ますかね！|風呂に入りますー|風呂あがったから寝ようかな|風呂入るね！|食べて風呂入ったらはなそっ|帰って風呂入って12時くらいになりそう|風呂あがった|俺も風呂あがった！|風呂はいる！|お風呂くらいゆっくりしてください！|風呂上がったら話せると嬉しいな！|うん！風呂はいるよー|帰って風呂入ったよー|風呂入ったからはなせます|風呂はいるっ|いつでも話せるけど風呂とご飯があります！|風呂はいったよー|風呂上がった！はなそー|風呂入るー|風呂あがったあ|ただいま！風呂はいるー|風呂はいる！あがったらはなしたい！|はい！風呂はいる！|こんばんは！風呂あがった|でも、昨日風呂も入ってないから|お風呂はいりますっ|疲れたので明日風呂にしてもうねます|風呂入る！目が疲れたー|風呂はいった|俺も風呂はいるっ|お風呂はいってるのかとおもったw|とりあえずご飯食べて風呂はいる！|風呂はいってきます！|風呂入って11時半くらいで！|風呂入った！|風呂は入れたけどまだ調子もどりません|俺も風呂はいる！|まだ風呂入ってないけど話せます|長風呂してた！もう少しまってて|風呂以外いつでもはなせます|ただいま風呂はいります|風呂入るから20分後くらいにはなそ|もうすぐ風呂はいりますっ|帰って風呂入って11時くらいに|おかえり！風呂あがったー|帰る時間教えてね！風呂沸かしときます|お風呂わかしちゅう！|お風呂入った？|風呂からはあがりました！|お風呂お願いしたいです！|眠たい...風呂入ってねよう😌|お風呂だけお願いします
お母さん	お母さんもありがとうございました！|お父さん、お母さんに聞いてみて！
アルバム	アルバムもすごくいい|アルバムありがとっ|共有というかアルバム？
人	この人はだれだろう？口がへこんでる！|席近い人たちだね|今日ね、職場の人に|雨風がすごくて、傘壊れて走ってる人がとても多かったです|左の人だね|結構アクティブな人そうだw|学校の人だと思った|その人にベースとボーカル捜しといてっていったので|今日は役員の人に|そろそろ面倒な人になるので|同期の人と飲んでます|今日は前の現場の人と飲んで帰るね|前の現場の人の家に泊まります|営業の人とご飯食べてたー|0.5日で振られてる人がいて、その手伝いです|ドラム叩いてた人がいてうずうずしてました|一番チャット回数が多い人にダイヤモンド|出始めで登録した人には勝てないさ|ホーム上に人が寝ているため|一番仲良かった人！|新しい職場の人と飲んでましたー|どうも新現場の人たちは|事務所には人はいる？|あと一人が夜光さんっていう、弟分みたいな人！|今日は隣の人が責められてて胃がキリキリ|ディズニーからの人でいっぱい！|職場の人と飲んで帰ります|知らない人ばっかりだからあまり乗り気じゃない|ううむ？全部同じ人？|人いっぱいだね|仲良くしてもらってた人がやめてしまうかも|明日は定時であがること現場の人に伝えたから|現場の人たちと麻雀やってました！|今日は他の人休みだからなしになった！|いい人多かったし、抜けるの惜しまれたし|自社の人俺一人だから居心地悪いー|降りる人に着いてけばいいと思うよー|一度言い出したら自分の意見が通るまで言い続ける人だからなあ...|同期の人はまだいる？|知らん人が出た|他の男の人と話してるのは、あまり気分はよくありませんね|年金の件は役所の土屋さんだか土田さんだか、男の人に聞いたよー|また前のバルテックの人と面談一緒だったから
だれ	この人はだれだろう？口がへこんでる！|さきはカラオケだれといったん？|俺はだれだろ、北関東の猿が好きかな！|だれもこなかったら帰っちゃおうと思ったけど
口	この人はだれだろう？口がへこんでる！
IMAGE	IMAGE
オールバック	オールバックじゃなくて
感じ	こんな感じにでこ見せがいいかなと|はて、笑い話で終わっちゃった感じ？|隣の市だったと思うからちょっと嫌な感じ|全体的に重たい感じです|ひげをどんな感じにしようか悩みます！|さきちゃんにはこんな感じで|いい感じの制服かな！|付き合う感じじゃないとはいってたけど|ちょっと白飛びしてるから、いい感じにしてもらいたい！|いい感じになった？|ゲリラ雷雨的な感じでした！|あとの二人がとっても大人しい感じだから|そんな感じ！|好きな感じの曲みつけた！|みんなうんうんって感じ|喉腫れてますねー、次ーって感じで|今日はいい感じに終わりました少し余裕も出てきたかなー|いい感じだね！|ふむふむ、なんかおしゃれな感じで落ち着くのがいいのかなと！|俺は1時半に出る感じ|クルージングは5時に家出る感じです|部屋は個室、しかない感じかな？|コース変えて、料理出すタイミングで声かける感じにしました|たぶん10時伊勢市駅でお願いする感じかな|入場:one love 退場:gutsはいい感じな気がする|ほぼみんな集まった感じかね|おー、いい感じのシフト|ゴールデン街という新宿のいい感じのとこでのんでます！|こちらは時間通りという感じです|初出勤はまあまあいい感じでした！|いい感じですね！|いい感じです！
安定	安定の玉山鉄二です！|今のところは安定してるけど|体重もあまり増減なく安定してきましたね|うんうん、安定してきてますね
玉山	安定の玉山鉄二です！
鉄二	安定の玉山鉄二です！
さま	おつかれさま！|ん！今週テストおつかれさま！|さきちゃん学校おつかれさま！|おつかれさま！がんば|さきちゃんバイトおつかれさま！|おつかれさま！うん、仕上げちゃおう|おつかれさま！さすがさきちゃん|さま！|おつかれさま！おやすみ|さま！目がつかれたー|うん、おつかれさま！|おつかれさま！明日からもばっちりですね|おつかれさま！お迎えにいきます|おつかれさま！9時頃かえりますー|おつかれさま！俺は830すぎです|おつかれさま！45分くらいにかえります|おつかれさま！はやい|おつかれさま！7時過ぎにはかえれますっ|おつかれさま！今日はちょっと残業してます|おつかれさま！楽しみ|おつかれさま！めずらしいー|おつかれさま！あと1時間くらいやって帰ります|おつかれさま！たぶん10時くらいに帰宅します！|おつかれさま！今日も昨日と同じくらいー|おつかれさま！今日は遅くなりそうです|おつかれさま！8時15分くらいにかえります！|おつかれさま！ほうほう|おつかれさま！帰宅中|おつかれさま！帰ります|おつかれさま！わかりました|おつかれさま！かえりますっ|早い！おつかれさま！|おつかれさま！今日はもう少しやって帰りますー|おつかれさま！帰るー|20分くらいかな？おつかれさま！|おつかれさま！帰るね|おつかれさま！かえるよー|おつかれさま！今日はちょっと残ってやってくね|残業おつかれさま！|はい、おつかれさま！|おつかれさま！かえりますー|おつかれさま！今日も遅くなりそうです|おつかれさま！かえってますー|おつかれさま！ルノアール朝ご飯|おつかれさま！830にはあがる予定です|おつかれさま！もうかえる！|さまです！|おつかれさま！かえってます|おつかれさま！新小岩15分後くらいかなー|おつかれさま！今から帰るから9時すぎかなあ|おつかれさま！メールするー|おつかれさま！帰りますねー|おつかれさま！ちょっと残業しましたー|おつかれさま！俺も今から帰ります！|おつかれさま！かえるー|おつかれさま！残業あがる！|おつかれさま！かえる！|おつかれさま！かえってます！|おつかれさま！秋葉いたからかえるねー|おつかれさま！ちょっと残って帰りますね|おつかれさま！帰れないんじゃよ！|おつかれさま！かえってるのです|はやい！おつかれさま！|おつかれさま！かえります|おつかれさま！かえります！|おつかれさま！もうそろそろあがりますー|おつかれさま！今日も残業予定じゃよ|かえる！おつかれさま！|おつかれさま！寒くない|おつかれさま！終わったら教えてね|おつかれさま！かえりますね|おつかれさま！俺の方がはやかったー|おつかれさま！早番だからあと少し|かれさま！|おつかれさま！図書館いたので俺も帰りますねー|おつかれさま！かえりますねー|おつかれさま！かえります🐅|おつかれさま！かえりますね～|おつかれさま！やったー|おつかれさま！かえりますん|おつかれさま！飲み行ってきますねー|おつかれさま！2階の奥います
仕事	もう少しで仕事おえますー|明日の朝は寒そうだし仕事も落ち着いてるから|仕事のかばんには入ってるんだけど|これじゃあ仕事になりません|すごい混んでたから仕事いくー|仕事終わらないとかいう問題じゃなく|前にやったとき15日かかった仕事を|明日も仕事だし早く帰らなきゃ！|仕事いってくるねっ|仕事の最寄り駅からバスがいやだからだけど|仕事いってきますっ|今日も明日も仕事ー|明日も仕事だあ|仕事いってきます|明日も仕事だし|仕事が次から次にな降ってくる|仕事納めなので飲んでから帰ります|軽く仕事して6時には家帰るね|チームメンバーが一人もいなくて仕事が全く進まない状態...|今仕事終わってから行くから、帰りは12時すぎるかそれくらいになるかと|今日は7時から面談あって、そのあと仕事に戻る予定だから|おお、仕事が早い...！|明日も仕事だし遅くならず帰るね！|仕事順調だったので帰ります！|とはいえ、仕事終わりで高円寺までいくのもなあと|こちらまだ仕事終わらず
気	気をつけてね！|気をつけて！|気をつけてねっ|気をつける|気をつける！|気をつけてきてね|気が早いね|はいっ、気をつけてね|うん！気をつけて帰って|ただ話してるうちは気は紛れたけど|ありがと気をつける！|うん、気をつけて|気をつけて|さきちゃん買い出し気をつけてね|気をつけてねいってらっしゃい|まだ帰れてないから気にせずいってあげて|気をつけて帰ります、おやすみ|はい！気をつけて|はい！さきちゃんも台風気を付けてね|はい！気をつけて！
大丈夫	うん、結構大丈夫|今回は大丈夫だと思います|大丈夫だよー|ううん、体調は大丈夫だけど|徒歩じゃなきゃ大丈夫かな|なんとなく目も開けられるようになってきたから大丈夫かな|さきちゃんまだ寝なくても大丈夫？|終電終バスともに大丈夫です！|消しちゃっても大丈夫そう|雨大丈夫かな？|さきちゃん5日予約して大丈夫？|三重は大丈夫？|大丈夫そう！|全然大丈夫！|大丈夫|うん！大丈夫！|なら、少しのお待ちで大丈夫かも！|おお、大丈夫だった？|それくらいなら大丈夫|二日酔いは全然大丈夫だったよー|大丈夫だと思う！|伊勢は大丈夫？|カルタなら大丈夫かな？百人一首苦手！|体調大丈夫！はなそっ|たぶん大丈夫|薬飲んでるから大丈夫！|のどは大丈夫？|雨降ってないみたいだから大丈夫！|いえいえ、全然大丈夫！いつもしてもらってるし|たぶん大丈夫かなあ|大丈夫！|あら、傘持ってこうと思ったけど大丈夫そう？|冷凍のパスタでも大丈夫です！|ううん、体調は大丈夫かな？|今日は晩ごはん社食で食べたから大丈夫！|小雨だったら大丈夫かも！|大丈夫のような気がするけど|少し遅くなってるから寝てて大丈夫|大丈夫だった|まだ大丈夫だけど、とりあえず出したいなーと思うけど|弱かったら大丈夫！|さきちゃんは大丈夫？|2人で行くから大丈夫です|上の標識見てれば大丈夫さ！|大丈夫かな
満足	満足しました！|満足|お弁当大変満足でした！
菱	菱縄縛りっていうみたい
縄	菱縄縛りっていうみたい|縄がソフトだったし、普通痛くないみたいだよー
ソフト	縄がソフトだったし、普通痛くないみたいだよー
嫌	痛いのは嫌だね！|隣の市だったと思うからちょっと嫌な感じ
注意	どんな注意事項だった？
事項	どんな注意事項だった？
テスト	さきちゃん明日テスト？|さきちゃんテストはどうですか？|テストは大変だー、なんか思い出して|テスト期間終わったら考えよう！|ん！今週テストおつかれさま！|テスト終わったら話そうね｡ﾟﾟ｡|さきちゃん明日もテスト？|さきちゃんテストがんば|テストおつかれさま|明日テストか|明日はテスト？|さきちゃんは明日もテストだよね|うん！さきちゃんもテストがんばってね|テストがんば|あ、そっか！テスト終わったらおしまいかと思ってた
イン	歯磨きしてインするねっ|もうかえひもすのでスカイぷイン|インして|インする！|さきちゃんがインしました|俺はいつでも話せる！インしてるね|インしたらかけるね|インしてるからかけて|インしておくね！
パソコン	疲れたー目いたいーもうパソコンみたくない|パソコンのセットアップしてたらこんな時間|岡山にノートパソコン持ってきてるんだけど|ちょっとまって、パソコンからかけます|秋葉で中古ノートパソコン買おうか悩んでます|アキバにパソコン見に行ってお勉強
あと	あと1時間ちょっとやって帰ります|あとよね除いて、4人には紹介させてもらいますので|俺もあと1時間くらいやって帰ります|あとドリンクバー！|ギター一人いたからあとベースとvocal！|あと後輩部下の接し方とか|あと1年くらいならっ|あと髪切ってきたよー|あとの二人がとっても大人しい感じだから|あと2日がんばろ|あと一人が夜光さんっていう、弟分みたいな人！|あと1時間がんばる！|疲れてるけどあと二日だ！|さきちゃんあと2日がんばろ|自転車だったらあと10分でつくのに！|あとほかのバンドのドラムが|あと2日！おはよ|あと2日|あと1日！|今日はあと30分くらいで家につく|あとで話しながら掃除しよ|あとね、10分くらい|さきちゃんあと少しがんばろ|あと一日だね！調子はよさそう？|家にいるならあとではなそっ|今日はあと3時間くらいでおわるかな|あとではなそっ|あとは資格試験だけだね|あと一日！|おやすみっ、あと一日がんばりましょ|あと1日|あとは見直してゆっくり寝ましょ|あと10分後くらいにかけるね|おー、あとは宅急便で送ればいいだけかな？|あら！あと20分くらいかな|あと10分後くらいにつきます|それか指輪取りに行ったあと、夕方くらいから横浜とか|おつかれさま！あと1時間くらいやって帰ります|あとで船橋に戸籍謄本とりいく！|今日は7時から面談あって、そのあと仕事に戻る予定だから|今日はあと1時間くらいであがります|あと5分後くらいかなあ|9時には送別会終わるからそのあと帰るね|あと鍵がありません|そのあとの話です|あとバスタオル白色なかったので、さきちゃんちあるかなあ|あと1時間は残りそうー|あと40分くらい
笑い話	はて、笑い話で終わっちゃった感じ？
了解	うん！了解です！|了解！|了解！予約しちゃうー|了解！帰りに振り込みます|了解ゞ|了解ゞ車で迎えにいくよ！|なんと了解しました！|7時すぎくらいだね。了解！
そっ	今後についてはまたはなそっ|明日はなそっ|また明日はなそっ>_<|はなそっ|さきちゃんはなそっ|さきちゃん11時半くらいにはなそっ|さきちゃん今日もはなそっ|さきちゃん帰ったらはなそっ|さきちゃん少しはなそっ|30分くらいにはなそっ|うん、夜はなそっ|うん、食べ終わったらはなそっ|食べて風呂入ったらはなそっ|今日もはなそっ|すこしはなそっ|20分にはなそっ|帰ったらはなそっ|11時前とかにはなそっ|今日は11時半くらいにはなそっ|夜はなそっ|11時半頃はなそっ|起きてたらはなそっ|さきちゃん夜もはなそっ|さきちゃん掃除中はなそっ|寝る前はなそっ|うん、話せるときはなそっ！|はなそっ　髪乾かしたらかけるね|今日はなそっ|きょうもはなそっ|家にいるならあとではなそっ|ただいま！今日もはなそっ|体調大丈夫！はなそっ|あとではなそっ|またはなそっ|今日ははなそっ|こんばんは！今日もはなそっ|あ、そっか！テスト終わったらおしまいかと思ってた|11時半くらいにはなそっ|そっか、とはいえ来てもらっても|今日は10時半頃帰るからはなそっ|そっか！対応お願いします|そっか、結構今日ピークかもね😢
隣	隣の市だったと思うからちょっと嫌な感じ|隣の市です|今日は隣の人が責められてて胃がキリキリ|コクーンビルの隣が職場！|花月の隣だとそば屋か中華かな？|akbカフェとガンダムカフェは隣みたいだね！
市	隣の市だったと思うからちょっと嫌な感じ|隣の市です
名古屋	名古屋大阪は平年並みらしいので、|来週ですね名古屋の宿とらなきゃ！|名古屋で開花！|早く名古屋にたどり着こう！|俺も名古屋ついた！|うん！まだ名古屋ついてないので|よかった！名古屋までゆっくりね|名古屋マラソンやってるけどそちらは暖かそうだ
大阪	名古屋大阪は平年並みらしいので、
開花	ほんとに開花するかぎりぎりになりそう|名古屋で開花！
サイゼ	サイゼで晩ご飯！|サイゼでご飯
ご飯	サイゼで晩ご飯！|ただいま！ご飯たべるー|ホテルでご飯！|姉夫婦と家族でご飯食べようってイベントが発生してます|朝ご飯！|営業の人とご飯食べてたー|サイゼリアでご飯食べて帰るので|親父とご飯食べてたから|ご飯食べる！|ああ、ご飯だ|ばあちゃんとご飯食べてお腹いっぱいー|ご飯食べるからそのあとかけるね！|ご飯食べて帰るー|サイゼでご飯|いつでも話せるけど風呂とご飯があります！|まだご飯中|ご飯たべる！|ご飯食べるから少しまって！|とりあえずご飯食べて風呂はいる！|晩ご飯どうしよう|ご飯一緒にたべよー|ご飯お願いします|晩ご飯の時間になった？|端っこの方でご飯食べよ！|昼は休憩ちゃんと取れるけどご飯は喉通らなかった|晩ご飯もそこそこ食べれたし、寒気もないし、治ってきました|今サイゼリヤでご飯食べてるから|あ、ご飯かってくる！|ご飯食べてくるから9時ぐらいがいいな！|今日は北口すぐのルノアールって喫茶店で晩ご飯！|ご飯セットなら890円なのでお得かなって|あ、まだ新幹線代入れてないからご飯食べたらふりこんどきますっ|ご飯たべた？|ご飯なにたべよー？|ご飯どうしよー？|ご飯食べてジムいこう|おかえりご飯食べてジムいきましょー|これからよねと会うのでご飯はいりません|さきちゃんご飯食べた？|コメダでご飯たべてます|ご飯はいっしょに食べよ！|皆でご飯食べて今日は会場で泊まり|さきにご飯食べておいて|あるとしたらご飯食べる前10時にさきちゃんち行って|ご飯はなにかなっ|今からご飯だから終わったら！|ご飯なにかな|帰ります！ご飯はなにかあるのかな？|ご飯はあるでしょうか|みんなとご飯食べて帰るながれかな？|ご飯はケバブでいいかなあと思ってる|俺両国でご飯食べるから同じくらいかも！|ご飯あるかな？|となりの大学でご飯たべます！|社長らとご飯たべてます|ご飯まだ食べてない！|ご飯食べてかえりますー|炊き込みご飯ってまだ残ってるのかな？|おつかれさま！ルノアール朝ご飯|今日のご飯もおいしゅうございました！|ご飯は食べずにかえるかと|飲みに行くのでご飯いりません！|ご飯食べた？|おそめの運転練習中。晩ご飯いっしょに食べよう！|ご飯なに食べようかなあ|ご飯食べて帰ります！|ほー、そしたらどこでご飯食べよう？|とりあえずご飯たべましょう|ご飯あります？|はい！俺はもう帰ってご飯たべたよー|ご飯ありますかっ|ご飯は家で食べます！|9時半ごろにはあがるので、ご飯お願いします|今日パスポート受取＋ご飯で船橋駅8時に|ご飯食べて帰りますね！|今日は歓迎会なのでご飯いりません！|白ご飯はあるから、おかずだけでも買い行こうか？|ご飯はそこそこ食べてます|俺はおーひとご飯いてきますねー|体調がまだあまりよくないから、なにか元気が出そうなご飯が食べたい|たぶん6時前に帰るから、新小岩でよねと一緒にご飯食べよー|ご飯まだ作ってなかったら焼き肉かお寿司たべよう
残念	残念！|残念！再利用できればいいけど|残念！なのかな？|残念|休めそうになくて残念かな|三重残念|それは残念。家いますね！
ピザ	ピザにしました
サラミ	サラミ、あんちょび、野菜、マルゲリータ
あん	サラミ、あんちょび、野菜、マルゲリータ|あんー？|あんびしゃすみたいな|だいきあんとだいきは違う？|だいきあんには浦野で予約してるのかな？
び	サラミ、あんちょび、野菜、マルゲリータ
野菜	サラミ、あんちょび、野菜、マルゲリータ
マルゲリータ	サラミ、あんちょび、野菜、マルゲリータ
どれ	どれでしょう！|どれくらい遅れそう？|どれがいいか決めかねる！さきちゃんはどれがいいと思う？|どれくらい降ってそう？
正解	正解！
商品	商品はなんだろうw|商品は京都2泊3日の旅です
なん	商品はなんだろうw|テストは大変だー、なんか思い出して|今日の予定はなんでしょう？|なんの写真だろ？|なんだろう？|なんだろう、結膜炎？ものもらい？|なんだろう！|なんだっけ！|予定はなんだったの？|なんだろう！絶対領域しか目に入りません|支店名はなんだろ？|おお、お子さんがなんにんか|なんの家具もないから|ふむふむ、なんかおしゃれな感じで落ち着くのがいいのかなと！|トムズカレーと同じなんだ。そこのラーメン辛そう|な、なんだろう|もはやすごすぎて、今まではなんだったのかレベルだ|なんにせよ、検査は行ってみよー|なんだろう
京都	商品は京都2泊3日の旅です|京都はどこ回るか考えなきゃ|京都の話してきます|京都じゃなくて伊勢だったら|まっぷるの京都ガイド買った！|東京も京都も明日かあさってじゃないかな
旅	商品は京都2泊3日の旅です
親父	親父が風呂あがったら風呂はいりますー|親父と焼き肉たべてきました！|親父一人で行くのも変でしょうw|親父と2人で泊めさせてもらってたかもね|親父とばあちゃんで成田に来てます！|親父とご飯食べてたから|親父ととんかつたべた！|そんな高いの買わなくていいぞって親父にいわれて|親父を舞浜まで送ってばあちゃんちきました！|契約書は貰ったのであとは親父に書いてもらって|親父からも明日姉らと一緒に花見しよういわれて|親父と会うことになったのだけれど、
ゃんおやすみっ	ん、さきちゃんおやすみっo|さきちゃんおやすみっ
o	ん、さきちゃんおやすみっo|さすがジョジョ(゜o゜;|そんなに驚くの(ﾟoﾟ;|バーベキューすごい(゜o゜;|少しじゃない(゜o゜;|早く復旧するといいね(゜o゜;|(゜o゜;(゜o゜;(゜o゜;|風邪ひいたみたいだから今日はお休み中o
ばか	ばかもーん！
返事	返事がないただのしかばねのようだ
ただ	返事がないただのしかばねのようだ
かばね	返事がないただのしかばねのようだ
ナッパ	よけろ、ナッパ！
かな	かな！|森本かなさん！|かな？|これに枠代8万とかかな？|それは俺のかな？探したけどなくてね
スカイプイン	スカイプインした！|スカイプインしてるからかけて|スカイプインしてるね|さきちゃんスカイプインしとくね|スカイプインします|スカイプインしてます|スカイプインします！|スカイプインするね|スカイプインしときます！|おかえり！スカイプインしてるからかけてっ|俺もスカイプインしてるね|スカイプインしてなくみえる|スカイプインしておいて>_<|スカイプインする！|スカイプインしといて|うん、スカイプインするね|俺はもう話せるからスカイプインしとくね|スカイプインするよー|おかえり！スカイプインするね
ゃんおはよっ	さきちゃんおはよっ
風	今日も寒くて風冷たくて凍死してしまうのかと思いました|風が強くて電車が遅れてる|なんか風が寒いね
凍死	今日も寒くて風冷たくて凍死してしまうのかと思いました
スーツ	さきちゃんもなかなかスーツ似合うようになった！|暖かいしスーツは素晴らしい！|あ、スーツ着たままのほうがいいですかね|スーツなの|昨日からスーツはジャケット、ネクタイです|昨日帰ってないからスーツだし疲れがたまってる|くたびれスーツ！|むかえいく！スーツのレシートあるかな？|スーツこうたので
大人	大人になったのか､､､∑|今日は大人っぽい服装だ|ちょっと大人っぽくなったかね！|昨日は大人っぽく見えたのに|おしゃれなイタリアンなので大人になった気分です！
､､､∑	大人になったのか､､､∑
集合	集合写真は卒業生も？|卒業式の集合写真と|いつのまに集合写真を...
卒業生	集合写真は卒業生も？
卑猥	なんて卑猥なれんらくもうw
れん	なんて卑猥なれんらくもうw|新小岩着く時間わかったられんらくするから|もー場フォンさいれんともーど
らく	なんて卑猥なれんらくもうw|新小岩着く時間わかったられんらくするから
女子	女子校の乗りか|女子の方が強烈なの実感しました
乗り	女子校の乗りか
席	席近い人たちだね|もうぷらっとこだま買わないで普通に自由席買った方が|千の杜6人じゃ仕切りないレストラン席になるて言われた|優先席付近では
反応	反応に困ります！電車の中なので！
電車	反応に困ります！電車の中なので！|風が強くて電車が遅れてる|電車にゆられてます|電車に揺られ　眠気が襲う|俺は今電車内でがんばってます！|電車遅れてて、え？ってなった|バス電車の遅れだからしょうがなかったよ！|電車タクシーなので早くなれない|普通の電車遅延で少し遅刻した！|ううん、今電車でかきばへー|6時前に起きて、今電車でむかってます|電車乗ったら連絡するね|俺も電車乗れたけどゆっくり|はい！電車さむ|電車のったらおしえて！
のり	こういう写真はのりのりでとるのか...
強烈	女子の方が強烈なの実感しました
実感	女子の方が強烈なの実感しました|話題的にもうおっさんだなと実感しました
ティッシュ	さきちゃんのティッシュとオレンジ？|ティッシュこうてきてー
オレンジ	さきちゃんのティッシュとオレンジ？
日本	日本アカデミーみてた！|今日日本代表のサッカー録っておいて
アカデミー	日本アカデミーみてた！
主演	主演女優賞のときだね
女優	主演女優賞のときだね
先生	先生に不思議ちゃんに思われそうw
不思議	先生に不思議ちゃんに思われそうw
スカイプ	スカイプ員してるからかけてね|どうもスカイプ調子よくなさそうだね|スカイプかけてー|スカイプいんした！
車	車運転してきました|車か|車に荷物おけるのはありがたいね|了解ゞ車で迎えにいくよ！|車で迎えにいきます|車があれば迎えにきてもらいたいなあと|実家着いて車あれば
運転	車運転してきました|うん、運転はしやすかったかな！|道が混んでて運転疲れたー|総武線各駅は平常運転になってるけど|って運転手がいってた|おそめの運転練習中。晩ご飯いっしょに食べよう！
白	白の？|白のズボン買うべきか悩む...|ちょっと白飛びしてるから、いい感じにしてもらいたい！|白ワインのグラスを飲んでます！|白？|白ご飯はあるから、おかずだけでも買い行こうか？
ひと	俺は風呂入っておーひと食べいってきます|おーひと飲んでますっ|いつものひとたちだ
家	家着は12時前です|家かえって試してみる！|今日は735に起きて745に家でました|前の現場の人の家に泊まります|もうすぐ家につきますっ|今日はあと30分くらいで家につく|家では窓にぷちぷちはって、床は100きんの|家帰って動画みるんだ！|今日はもうすぐ家につける|家にいるならあとではなそっ|同期の家に遊びにいってました！|新小岩の家にきました|家にいる！|家には3時には帰れるかな|クルージングは5時に家出る感じです|7時には家つきます！|それでいいといったけど、家にはあげません！|家の掃除はしてない|軽く仕事して6時には家帰るね|8時には家つくよー|家で待ちます！|クレカがくるので家で待機してます！　|は！いったん家帰ります！|寒いので家待機！|もう家帰ったよー|俺もそのころ家戻るよー|とりあえず家に！|ご飯は家で食べます！|そろそろ面談終わって家着きます|それは残念。家いますね！|指輪はめてこなかったかなと思うんだけど、家にあるかな...？
かい	すかいぷいんしといてー|かいにいかなきゃ！|かいものしてる！|ケンタッキーかいにいこうかなー
ぷいんしといて	すかいぷいんしといてー|すかいぷいんしといて
言葉	とのお言葉です
卒業	卒業式の集合写真と|看護学校卒業だけで十分な手みやげですよ！！|もうすぐ卒業さ！
ホテル	前のホテルの写真見せました！|ホテルでご飯！
大分	おそらく大分評価高いと思われますよ
評価	おそらく大分評価高いと思われますよ|上の会社が同じで俺の評価高いみたいだからがんばらねば
友人	会ってもらいたい友人なので|友人らは住所わかるから
紹介	紹介させてね！|あとよね除いて、4人には紹介させてもらいますので|転職サイトΣいいとこ紹介してもらえるといいね！|自己紹介的なものをそこですることになるのかな
そめ	あと、おそめとしばかな|おーひ、よね、おそめと飲んでます|おそめの運転練習中。晩ご飯いっしょに食べよう！|おそめは帰ったからいいとこで切り上げるねー|おそめと飲んできた！
しば	あと、おそめとしばかな
宮下	宮下くんとか|宮下くんは映画助監督
りょうしょう	ごりょうしょうください
駅	今駅からあるいてます|駅近い南口できれい！|駅の焼き肉屋まできたので|いこう！駅までむかえお願いっ|駅行こうと思うからのぞいてみようかな|駅にはいつつくかな？|駅までこれるー？|駅着く頃おしえてね！|駅→着付けのとこ→さきちゃんちと回ってもらうかと|駅行るので着く頃おしえてれ！|駅いるので着く頃教えてね|駅何分？|駅にいるので着く頃教えてね|駅迎えに行く！|駅にいるので終わったら教えて|職場から駅までは降ってなかったから|駅迎えにきて|駅いたけど帰るね！|駅でいいかな？|駅までいくね|駅にいるので着く頃教えてね！|駅におりますので、着く頃教えて|駅？|30分ごろに駅いくー|駅で一緒に食べようか？|駅でまってる！
なに	なにかににてるなーとおもいました|なにかななにかな|それはなにより！|さきちゃんになにしてもらおうかな|なにしようかねさきちゃん！|バドミントンとなにしよw|俺も3連休！なにしようか|さきちゃんは正月なにしてる？|ご飯なにたべよー？|なにかかってかえろう|さきちゃんちに行ってなにすればいいのか|ご飯なにかな|なに探してたの？|俺もなにもできてないw|ご飯なに食べようかなあ|たのしんでるようでなにより|なにたべたい？|なにがいい？
実写	実写かねらい！
ひも	もうかえひもすのでスカイぷイン
スカイ	もうかえひもすのでスカイぷイン|スカイぷいんしてます|夕方頃からスカイツリーいこう
ぷ	もうかえひもすのでスカイぷイン|りあるすこーぷ
映画	宮下くんは映画助監督|ダブルフェイス？って映画テレビでみてた！|映画借りてきた|ガンダムの映画が入ってました！|さきちゃん映画見終わったー？
助監督	宮下くんは映画助監督
二日酔い	ほんとー、ちょっと二日酔いかも|二日酔いは全然大丈夫だったよー
口ひげ	口ひげは剃って、あごだけにしようか
あご	口ひげは剃って、あごだけにしようか|あごの痛みすらひいてきたよ！
りき	おー、りきさく！
さく	おー、りきさく！
ミク	たしかにミクの日だ
ぱちお	ぱちお氏は順調にうまくなっている...
順調	ぱちお氏は順調にうまくなっている...|順調だね！|帰り道は順調？|順調だね！いえいえ|帰りは順調？|こっちは順調です！|おお、順調な滑り出し|仕事順調だったので帰ります！|順調ですね|順調なようですね
商業	もはや商業用になってる∑
∑	もはや商業用になってる∑|名字も知られてるのか∑|さきちゃんがサバゲー∑|∑|お父さんに∑|さきちゃんもう寝ちゃう∑|ナース服∑|エステでマッサージしたレベルじゃない∑
ぷいんしてます	スカイぷいんしてます
い	さむいいいい
薬	薬も飲まねば|薬のんでない帰ったら飲みます！|さきちゃんに言われたときすぐ薬のむんだったー|また風邪気味、、、薬飲んでねます！|帰りに効く薬かってかえるよー|薬もらってそれ飲めばよくなるはずっ|喉の薬もらって終わりました|薬飲んでるから大丈夫！|薬かってくる|薬忘れてる...？
名字	名字も知られてるのか∑
胸	寒かったけどなんとか胸痛くならずすみました...|胸が痛いのでくすりのみます
出口	寒さの出口が見えてきています（NHK）
NHK	寒さの出口が見えてきています（NHK）
名前	名前はわからない！|名前がわからない！
うめ	うめ！|えんまる、ぼかろか、うめきち、とんこいわ、ヴあまんま、はいから、
休	明日は午前休でいいかな|進捗みんな遅れてて休出するみたい|明日午前休もらったから一緒に役所いこう
体調	ううん、体調は大丈夫だけど|体調はいいんだけどね！精神的に疲れた！|体調大丈夫！はなそっ|体調がひどくわるい|ううん、体調は大丈夫かな？|しおん氏体調不良で帰りますー|体調がまだあまりよくないから、なにか元気が出そうなご飯が食べたい
フレックス	フレックス！
ほんと	ほんとだ！|ほんとだ！今日はお絵かきかな|ほんとだ！ふくの模様とかだね|ほんとだ
きん	きんとれ！|家では窓にぷちぷちはって、床は100きんの|100きんよる！|100きんよってかえるー|きんし50分くらいかなあ
ぁいと	ふぁいと！
筋	筋トレ終わったので俺も考え事します|筋トレして代謝あげる|筋トレしよう！
トレ	筋トレ終わったので俺も考え事します|筋トレして代謝あげる|筋トレしよう！
考え事	筋トレ終わったので俺も考え事します
うち	うちミス！|おーひがうちにきます！|うちに置いとけるものは置いてこう|おうちにつきました|おうちかえります|ううん、おうち！|おうち帰っても寂しいだけなので！|おうちでまってます！|雨降りそうなのでおうち待機|おうちでゆっくりしよう|はい！おうち待機！|いったんおうちで様子みてからいきましょか|うち換気のため窓あけてます！
ミス	うちミス！
規模	俺はその規模は乗り気にならないw
乗り気	俺はその規模は乗り気にならないw|知らない人ばっかりだからあまり乗り気じゃない
冬	俺は来年冬を乗り切るために考えます|お金があれば冬もこわくない！|どうも冬はだめだ
代謝	筋トレして代謝あげる
カレー	カレーとかしょうがたべる　|今日はカレーが食べたい
かしょう	カレーとかしょうがたべる　
物知り	さきちゃん物知り！
田邊	さすが田邊さん、綺麗に撮る|田邊さんにもきいておいて|田邊さんどりですね！
綺麗	さすが田邊さん、綺麗に撮る|家具そろえて綺麗にしてからきてもらおう！
焼き肉	親父と焼き肉たべてきました！|駅の焼き肉屋まできたので|いい焼き肉やあるかなー？|ご飯まだ作ってなかったら焼き肉かお寿司たべよう
お腹	お腹いっぱい！|ばあちゃんとご飯食べてお腹いっぱいー|お腹減った～|お腹いたい
大変	テストは大変だー、なんか思い出して|中高も大変でした！|覚えるの大変！|通勤が大変！|大変そうだけどいろいろ勉強にもなりそうかな|大変！|あったら大変だなって|相続は大変だねえ、さきちゃん|大変だ|結構大変そうなスケジュールだ|そりゃ大変だったねー|月曜雨は大変だ|大変だったようで|朝は大変だったでしょう|大変そう！|お弁当大変満足でした！|登るの大変じゃったね！
中高	中高も大変でした！
どこ	京都はどこ回るか考えなきゃ|どこのモデルでしょう！|1.次の旅行どこ行くか|あれ、どこいるんだろ？|さきちゃんどこいくの|さきちゃんはどこだろ？|どこか出かけてたのかな|どこの写真だろ？|レンタカー借りれたらレンタカーでどこかいこうか|うーん、どこだろう|どこでも|あら、どこだろう|どこかいこうか|どこにあるの|どこだろ？|届けられるけどどこー？|俺もいく！どこにいく？|ほー、どこいこうか？|ほー、そしたらどこでご飯食べよう？|はい！どこ口だろ？|華禅あったような気がするけど、どこかわからぬ|どこへいきます？|どこいこう？|あら、どこやったかなあ|夜はどこか食べいこうか|特にどこかは決めてないけど！
期間	テスト期間終わったら考えよう！
希望	おそらく俺の希望メインになるかと！
メイン	おそらく俺の希望メインになるかと！
みなさん	みなさんの意見とりいれますっ|みなさん塾考をかさねたけっか|みなさんでこなくても
意見	みなさんの意見とりいれますっ|一度言い出したら自分の意見が通るまで言い続ける人だからなあ...
恋	恋みくじはいらないでしょう
くじ	恋みくじはいらないでしょう
我慢	今あるもので我慢だよ！|来年まで我慢！
折り返し	折り返しがんばろ
削除	削除できたー
職場	今日ね、職場の人に|新しい職場の人と飲んでましたー|職場の人と飲んで帰ります|コクーンビルの隣が職場！|職場から駅までは降ってなかったから|職場見学とやらいってきましたー
西崎	「西崎さんってオダギリジョーに似てますよね？言われません？」|西崎君のこと！
オダギリジョー	「西崎さんってオダギリジョーに似てますよね？言われません？」|オダギリジョーは怒られそうだから、玉鉄方向でいきます！
髪	もう少し髪伸びたらもう少し似るかな|さきちゃん髪切った？|今日髪切りに行く予定だったんだけどなあ|あと髪切ってきたよー|髪切ります！|髪乾かしてかけるね|はなそっ　髪乾かしたらかけるね|赤い髪のって！|髪乾かすのですこしおまち|髪切ったのでバンド練いきますっ|髪切りプラスぶらつきに津田沼いってくるねっ|今日は髪切りに行きます！|髪切ってフードプロセッサー買えた|予定通り髪切りに行って帰るから930くらいになると思います！|うん、髪きったとこ|髪切って帰るのでたぶん9時前くらいかな|髪巻いたんだ！|髪切るんじゃ！|髪きったんじゃ！|髪切りました！|髪は切り終わりました！
玉	オダギリジョーは怒られそうだから、玉鉄方向でいきます！
鉄	オダギリジョーは怒られそうだから、玉鉄方向でいきます！
方向	オダギリジョーは怒られそうだから、玉鉄方向でいきます！
http	http://www.tenki.jp/lite/forecaster/diary/m_seta/2014/03/12/8901.html|http://sakura.weathermap.jp/smt/#area_5|http://amphiprion.misujitate.com|YouTubeで「藍井エイル　 『サンビカ  --サビver.-』: http://youtu.be/WAYZokHz1L0|http://watergrass0000.wordpress.com|http://www.nagoya-boston.or.jp/event/list/gogo71-76.html|http://www.jalan.net/us/usp3000/usw3001.do?yadNo=327592|YouTubeで「fox capture plan / 疾走する閃光」を見ませんか - fox capture plan / 疾走する閃光: http://youtu.be/KFstP0C9sVk|http://www.bellesalle.co.jp/room/sankaku/|引っ越し, http://www.amazon.co.jp/registry/wishlist/VBMAP29JAKSH/ref=cm_sw_r_li_awwlo_0nx6ub1937AWS|http://www.ryu-tsu.co.jp/kakaku.html#diamond|http://www.takara-kiho.co.jp/design_ring/design_ring.html|http://hlo.tohotheater.jp/net/schedule/029/TNPI2000J01.do#showing_schedule|http://www.ise-kamimura.jp|http://www.kirby.jp/25th/|http://hiygia.mydns.jp:8000/bot/|http://bonojojo.mydns.jp/bot/saki
://	http://www.tenki.jp/lite/forecaster/diary/m_seta/2014/03/12/8901.html|http://sakura.weathermap.jp/smt/#area_5|http://amphiprion.misujitate.com|YouTubeで「藍井エイル　 『サンビカ  --サビver.-』: http://youtu.be/WAYZokHz1L0|http://watergrass0000.wordpress.com|http://www.nagoya-boston.or.jp/event/list/gogo71-76.html|http://www.jalan.net/us/usp3000/usw3001.do?yadNo=327592|YouTubeで「fox capture plan / 疾走する閃光」を見ませんか - fox capture plan / 疾走する閃光: http://youtu.be/KFstP0C9sVk|http://www.bellesalle.co.jp/room/sankaku/|引っ越し, http://www.amazon.co.jp/registry/wishlist/VBMAP29JAKSH/ref=cm_sw_r_li_awwlo_0nx6ub1937AWS|http://www.ryu-tsu.co.jp/kakaku.html#diamond|http://www.takara-kiho.co.jp/design_ring/design_ring.html|http://hlo.tohotheater.jp/net/schedule/029/TNPI2000J01.do#showing_schedule|http://www.ise-kamimura.jp|"ディヴィニティ：オリジナル・シン　エンハンスド・エディション_20160622002653" を YouTube で見る - https://youtu.be/T-ugBPbFcLw|"FF4　愛のテーマ　ピアノ" を YouTube で見る - https://youtu.be/I2fGXP9RLes|https://youtu.be/8OQaCVMF1zo|http://www.kirby.jp/25th/|http://hiygia.mydns.jp:8000/bot/|http://bonojojo.mydns.jp/bot/saki|https://dev.to
www	http://www.tenki.jp/lite/forecaster/diary/m_seta/2014/03/12/8901.html|http://www.nagoya-boston.or.jp/event/list/gogo71-76.html|http://www.jalan.net/us/usp3000/usw3001.do?yadNo=327592|http://www.bellesalle.co.jp/room/sankaku/|引っ越し, http://www.amazon.co.jp/registry/wishlist/VBMAP29JAKSH/ref=cm_sw_r_li_awwlo_0nx6ub1937AWS|http://www.ryu-tsu.co.jp/kakaku.html#diamond|http://www.takara-kiho.co.jp/design_ring/design_ring.html|http://www.ise-kamimura.jp|http://www.kirby.jp/25th/
.	http://www.tenki.jp/lite/forecaster/diary/m_seta/2014/03/12/8901.html|http://sakura.weathermap.jp/smt/#area_5|http://amphiprion.misujitate.com|YouTubeで「藍井エイル　 『サンビカ  --サビver.-』: http://youtu.be/WAYZokHz1L0|http://watergrass0000.wordpress.com|1.次の旅行どこ行くか|2.会社の今後について|3.太るのをどう食い止めるか|0.5日で振られてる人がいて、その手伝いです|http://www.nagoya-boston.or.jp/event/list/gogo71-76.html|http://www.jalan.net/us/usp3000/usw3001.do?yadNo=327592|YouTubeで「fox capture plan / 疾走する閃光」を見ませんか - fox capture plan / 疾走する閃光: http://youtu.be/KFstP0C9sVk|http://www.bellesalle.co.jp/room/sankaku/|引っ越し, http://www.amazon.co.jp/registry/wishlist/VBMAP29JAKSH/ref=cm_sw_r_li_awwlo_0nx6ub1937AWS|さっきはかったら38.2度だった|0.341　G　VS2　3EX H&C　90,330円　GIA鑑定書付 ○|0.346　F　SI1　3EX H&C　89,570円　○|http://www.ryu-tsu.co.jp/kakaku.html#diamond|http://www.takara-kiho.co.jp/design_ring/design_ring.html|http://hlo.tohotheater.jp/net/schedule/029/TNPI2000J01.do#showing_schedule|http://www.ise-kamimura.jp|"ディヴィニティ：オリジナル・シン　エンハンスド・エディション_20160622002653" を YouTube で見る - https://youtu.be/T-ugBPbFcLw|"FF4　愛のテーマ　ピアノ" を YouTube で見る - https://youtu.be/I2fGXP9RLes|https://youtu.be/8OQaCVMF1zo|http://www.kirby.jp/25th/|http://hiygia.mydns.jp:8000/bot/|1年半前　181.8 / 65.8 →　今回　181.7 / 64.7|http://bonojojo.mydns.jp/bot/saki|https://dev.to
tenki	http://www.tenki.jp/lite/forecaster/diary/m_seta/2014/03/12/8901.html
jp	http://www.tenki.jp/lite/forecaster/diary/m_seta/2014/03/12/8901.html|http://sakura.weathermap.jp/smt/#area_5|http://www.nagoya-boston.or.jp/event/list/gogo71-76.html|http://www.bellesalle.co.jp/room/sankaku/|引っ越し, http://www.amazon.co.jp/registry/wishlist/VBMAP29JAKSH/ref=cm_sw_r_li_awwlo_0nx6ub1937AWS|http://www.ryu-tsu.co.jp/kakaku.html#diamond|http://www.takara-kiho.co.jp/design_ring/design_ring.html|http://hlo.tohotheater.jp/net/schedule/029/TNPI2000J01.do#showing_schedule|http://www.ise-kamimura.jp|http://www.kirby.jp/25th/|http://hiygia.mydns.jp:8000/bot/|http://bonojojo.mydns.jp/bot/saki
/	http://www.tenki.jp/lite/forecaster/diary/m_seta/2014/03/12/8901.html|http://sakura.weathermap.jp/smt/#area_5|181/66ならまだちょい痩せくらいだけど|YouTubeで「藍井エイル　 『サンビカ  --サビver.-』: http://youtu.be/WAYZokHz1L0|http://www.nagoya-boston.or.jp/event/list/gogo71-76.html|http://www.jalan.net/us/usp3000/usw3001.do?yadNo=327592|ＪＲ総武線/新小岩 歩8分|YouTubeで「fox capture plan / 疾走する閃光」を見ませんか - fox capture plan / 疾走する閃光: http://youtu.be/KFstP0C9sVk|http://www.bellesalle.co.jp/room/sankaku/|引っ越し, http://www.amazon.co.jp/registry/wishlist/VBMAP29JAKSH/ref=cm_sw_r_li_awwlo_0nx6ub1937AWS|http://www.ryu-tsu.co.jp/kakaku.html#diamond|http://www.takara-kiho.co.jp/design_ring/design_ring.html|http://hlo.tohotheater.jp/net/schedule/029/TNPI2000J01.do#showing_schedule|"ディヴィニティ：オリジナル・シン　エンハンスド・エディション_20160622002653" を YouTube で見る - https://youtu.be/T-ugBPbFcLw|"FF4　愛のテーマ　ピアノ" を YouTube で見る - https://youtu.be/I2fGXP9RLes|https://youtu.be/8OQaCVMF1zo|http://www.kirby.jp/25th/|http://hiygia.mydns.jp:8000/bot/|1年半前　181.8 / 65.8 →　今回　181.7 / 64.7|6/11ランチみたいです|http://bonojojo.mydns.jp/bot/saki
lite	http://www.tenki.jp/lite/forecaster/diary/m_seta/2014/03/12/8901.html
forecaster	http://www.tenki.jp/lite/forecaster/diary/m_seta/2014/03/12/8901.html
diary	http://www.tenki.jp/lite/forecaster/diary/m_seta/2014/03/12/8901.html
m	http://www.tenki.jp/lite/forecaster/diary/m_seta/2014/03/12/8901.html
_	http://www.tenki.jp/lite/forecaster/diary/m_seta/2014/03/12/8901.html|http://sakura.weathermap.jp/smt/#area_5|引っ越し, http://www.amazon.co.jp/registry/wishlist/VBMAP29JAKSH/ref=cm_sw_r_li_awwlo_0nx6ub1937AWS|http://www.takara-kiho.co.jp/design_ring/design_ring.html|http://hlo.tohotheater.jp/net/schedule/029/TNPI2000J01.do#showing_schedule|"ディヴィニティ：オリジナル・シン　エンハンスド・エディション_20160622002653" を YouTube で見る - https://youtu.be/T-ugBPbFcLw
seta	http://www.tenki.jp/lite/forecaster/diary/m_seta/2014/03/12/8901.html
html	http://www.tenki.jp/lite/forecaster/diary/m_seta/2014/03/12/8901.html|http://www.nagoya-boston.or.jp/event/list/gogo71-76.html|http://www.ryu-tsu.co.jp/kakaku.html#diamond|http://www.takara-kiho.co.jp/design_ring/design_ring.html
桜	桜平年並みみたい|うん、桜はよさそうだけど天気がね|桜盆栽
sakura	http://sakura.weathermap.jp/smt/#area_5
weathermap	http://sakura.weathermap.jp/smt/#area_5
smt	http://sakura.weathermap.jp/smt/#area_5
/#	http://sakura.weathermap.jp/smt/#area_5
area	http://sakura.weathermap.jp/smt/#area_5
完璧	完璧なようです|おお、完璧だね！
ゃんおはよ	さきちゃんおはよ|さきちゃんおはよ！|さきちゃんおはよ？
好き	俺も好きだよー|俺はだれだろ、北関東の猿が好きかな！|俺も好きー|俺も好き|錦糸町駅が結構好きだからそこがいいなあとは思うけど|三井住友とみずほはどっちが好き？|俺も好きー！|好きすぐてになってる！|好きな感じの曲みつけた！|好き！|俺も好きっ|好き
雨風	雨風がすごくて、傘壊れて走ってる人がとても多かったです
傘	雨風がすごくて、傘壊れて走ってる人がとても多かったです|あら、傘持ってこうと思ったけど大丈夫そう？|傘無い|15分後くらいに傘もってきます！|ううん、傘はあります|さきちゃん傘ある？|着く頃傘お持ちします|雨降ってたら傘を|傘忘れた！|傘欲しい！
おと	おとうとくんか？
立派	立派なケーキだー
ケーキ	立派なケーキだー
想像	なんだか将来のさきちゃんを想像してしまった
服装	今日は大人っぽい服装だ|服装が大きいかな！
とこ	俺も今帰ったとこ|来年はさきちゃんと都内に近いとこに引っ越しましょう|切りのいいとこまでやってかえります|さきちゃんと住むとこね|ううん、もうジム行って帰るとこ|船橋ぶらついて今から帰るとこ|転職サイトΣいいとこ紹介してもらえるといいね！|中央改札出て左前いったとこにある|像のとこいるね！|俺はついたよ！昨日のとこいるね|タクシーとまってるとこがロータリーです！|あいてるとこあるかなあ..|つけるとこはあるよー|ヴィアマンマってとこでパスタ食べたので帰ります！|うん、髪きったとこ|いいとこどり！|早く着てるとこもみたい|今終わったとこなので遅くなります！|ほかよさそうなとこありそう？|12日フェアでいいとこあるかな！|こんなとこ！|駅→着付けのとこ→さきちゃんちと回ってもらうかと|おしゃれなとこで飲んでますね！|いつものみすどのとこいくねー|切りの良いとこまでやって帰るね|とくに変わったとこはなさそう|書けるとこはかいちゃっておいて！|商店街にあるとこね|たぶん15分くらいだから行くとこおしえてて！|日暮里のとこ？|ゴールデン街という新宿のいい感じのとこでのんでます！|おそめは帰ったからいいとこで切り上げるねー|着いたけど、バス泊まってたとこでいいだろうか？|階段のとこで待ってるね！|そしたらこっちの階段おりたとこにしよう|昨日のとこで決まった！
めがね	めがねかけて写真とってみた！
久しぶり	自撮りは久しぶりです|久しぶりに家族全員家だ
イメチェン	ちょっとイメチェンでした！
一眼	一眼レフではないでしょ？
レフ	一眼レフではないでしょ？
相方	あれ？借りたのは相方ちゃんか
>_<	また明日はなそっ>_<|起きてて>_<|セクシーなの欲しいな>_<|スカイプインしておいて>_<
変	変顔ww|送ったらってあの変顔！？|親父一人で行くのも変でしょうw
ww	変顔ww
ゃんおはよおお	さきちゃんおはよおお
予定	今日の予定はなんでしょう？|今日髪切りに行く予定だったんだけどなあ|予定はなんだったの？|今日は早く帰って11時には寝る予定！|予定です|今日は俺定時にあがる予定だから|ちなみに俺は1936到着予定|22日に来ていつごろまでいる予定かな？|これで行く予定！|予定通り髪切りに行って帰るから930くらいになると思います！|9時には帰る予定！|今日は7時から面談あって、そのあと仕事に戻る予定だから|もうそろそろあがる予定だけど、タブレット届いてるか見てもらいたいな！|変える予定です|定時ダッシュ予定だから、新小岩南口6:45位だと思う|おつかれさま！830にはあがる予定です|10時頃にはあがる予定！えんまるにでもいこー|ケバブかって帰るんや！昨日と同じ11時頃帰宅予定です|もうすぐあがる予定|予定通り9時ごろには帰ります！|明日の午前中に届く予定です|おつかれさま！今日も残業予定じゃよ|11時頃帰宅予定です|もうすぐあがる予定です！|その予定でいくね！|7時半に出て鳥羽駅に12時半に着く予定ですよー|近鉄も乗れた！12:23着予定です|ぎりぎり座れた...17:27着予定です|27番で説明受ける予定です
サバゲー	さきちゃんがサバゲー∑
きんこ	きんこつりょう
りょう	きんこつりょう|りょうがあったから買っちゃった！
ほお	ほお|ほおほお|ほお、なんだか意味深な|ほおー|ほお？
アウトレット	アウトレットで買い物中～|もういっこのアウトレットいくー|海ほたる通ってアウトレットいきます！
買い物	アウトレットで買い物中～|買い物行くなら明るい道でね|今日はようけ買い物しました|今日はお買い物しにいきます|買い物できてよかったさ|お買い物かな|いいお買い物ですね|津田沼に買い物にいきます！|買い物おえたのでかえりますっ|こんばんは！今日もぼちぼち買い物してました|買い物できたー？|ファミマで買い物しよー|買い物します|買い物はすぐ終わりそうなので結構待ちます|いいお買い物だね
～	アウトレットで買い物中～|今帰ってるところだから12時過ぎに話せるといいな～|ドリンク含めて一人7000～8000円だろうからちょうどいいかな|ありがたや～|帰ります～|お腹減った～|おつかれさま！かえりますね～|8時に南口で待ち合わせましょ～|ありゃ～|おつかれさま～|ありゃ、そのまま帰る～|俺もいこ～|数藤氏宅にもうすぐ着きます～|ね！半くらいに帰るね～|19:15くらいに帰る～|レコーダーとテレビは5000円になったよ～
これ	これだ！ってものがない|これ以上は死守しないと|これなら保存してもいい？|これじゃあ仕事になりません|たぶんこれインストールすればいけると思う...|これこうた！|これで行く予定！|いろいろ考えて考えてこれかなあ、って|これとかすごいコスパいい|これとかも|これに枠代8万とかかな？|結婚式の二次会からなのでこれ3じかいです|これで顔合わせもばっちりだね|これも良い曲！|迎えにこれそうかなあ
ジャケット	ジャケット！|ジャケットかった！|ジャケット買ってよかった！ヒゲそってないけれどw|昨日からスーツはジャケット、ネクタイです
絵かき	ほんとだ！今日はお絵かきかな
がん	うんうん、勉強がんば|さきちゃんテストがんば|さきちゃんも最後がんば|さきちゃんは明日から学校がんば|さきちゃんバイトがんば|おつかれさま！がんば|うん、レポートがんば|テストがんば|ドイツがんばれえええ|バイトがんば|うん、がんば
ズボン	白のズボン買うべきか悩む...|下が黒いズボン
別人	別人！
灰色	灰色にしようか
モデル	どこのモデルでしょう！
裾	裾上げ中です|錦糸町で裾直しとかしてたから今から帰るね！
上げ	裾上げ中です
ばあちゃん	ばあちゃんち寄ったりで疲れたー|ばあちゃんの誕生日とのことで|親父とばあちゃんで成田に来てます！|ばあちゃんとご飯食べてお腹いっぱいー|ばあちゃんが傘寿なのですが|親父を舞浜まで送ってばあちゃんちきました！|俺はばあちゃんちから今帰ってます
青色	着てみたら結構青色だー
ヒゲ	ジャケット買ってよかった！ヒゲそってないけれどw
無精	無精ひげではない！
セーフ	セーフ！
｡	テスト終わったら話そうね｡ﾟﾟ｡|まだ帰れそうにない｡ﾟﾟ｡
ﾟﾟ	テスト終わったら話そうね｡ﾟﾟ｡|まだ帰れそうにない｡ﾟﾟ｡
左	左の人だね|中央改札出て左前いったとこにある|改札出て左いって、|南口改札でて、斜め左の入口から地下へ
アクティブ	結構アクティブな人そうだw
宿	来週ですね名古屋の宿とらなきゃ！|昨日宿は取りましたっ|宿の予約もできました！|いつもは宿込みだとそれ以上！
駐車	駐車場あるのかな
交通	さきちゃん交通費浮くのかな
はな	はなそっ|はなそっ　髪乾かしたらかけるね|体調大丈夫！はなそっ|今日は10時半頃帰るからはなそっ
ゃんいんしてない	さきちゃんいんしてない
こたつ	こたつでねてた
奇抜	奇抜な髪型！
髪型	奇抜な髪型！
おしまい	明日でおしまいかな？|明日でおしまい！|あ、そっか！テスト終わったらおしまいかと思ってた
伊勢	んーん、伊勢の後松阪とか鈴鹿寄ろうかとか|伊勢には夜はいないと思う|京都じゃなくて伊勢だったら|俺もまた伊勢いきたいです！|伊勢9℃！さむいね|伊勢はあったかそう？|気温見てみると伊勢すごい寒そう|伊勢11℃になってたー|寒そう伊勢8どになってるよ！|伊勢は大丈夫？|たぶん10時伊勢市駅でお願いする感じかな|三重県 伊勢市一之木3丁目 15-1 美容室アリア
松阪	んーん、伊勢の後松阪とか鈴鹿寄ろうかとか|津と松阪の間とか
鈴鹿	んーん、伊勢の後松阪とか鈴鹿寄ろうかとか
家族	さきちゃん家族も知ってるのねw|姉夫婦と家族でご飯食べようってイベントが発生してます|久しぶりに家族全員家だ
最後	さきちゃんも最後がんば|最後までやると面白いみたい|今週最後がんばろー|今週最後はりきっていきましょう|最後だがんばろう|今週も最後だ！|今週も最後がんばろ|最後だね！
!!	おめでとう!!|ロキソニンは秘薬ですね、、!!|おわった...！圧倒的に帰る!!
終バス	終バスは乗れる|終バスあるのはすばらしい！|終バスなさそうだからタクシーかなあ|終バスのれました！|終電終バスともに大丈夫です！
お茶の水	今お茶の水|今お茶の水だけど先入ってて|俺もお茶の水のりかえで20分くらいでいけそうだけど|お茶の水のりかえです
春休み	春休みだし！
道	買い物行くなら明るい道でね|道が混んでて運転疲れたー|道工事してて
徒歩	徒歩じゃなきゃ大丈夫かな
自信	今ならとばされない自信がある
kg	66kgになってしまったからね！
死守	これ以上は死守しないと
酒	お酒そこそこ飲みました|お酒が好きそうです|お酒のみたい！|お酒を飲もう
カラオケ	さきはカラオケだれといったん？
学校	学校の人だと思った|さきちゃんは明日から学校がんば|さきちゃん学校おつかれさま！|ん？看護学校か！|学校いってらっしゃい|さきちゃん学校いってらっしゃい|看護学校卒業だけで十分な手みやげですよ！！|ううん、学校で新しい課題出されていけないよー|学校おつかれさま|あれ、明日も学校？
市川	今は市川駅です|ひらい、しんこいわ、こいわ、市川、もとやわた、下総中山、西船橋、ふなばし|花火大会は市川市側で見よう！
かぜ	かぜひいちゃう！
ゃんいんして	さきちゃんいんしてー
かばん	仕事のかばんには入ってるんだけど|全部のかばんにいれときます！|かばんかけるの買って帰ろうかなあ
ぷるの	まっぷるの京都ガイド買った！
ガイド	まっぷるの京都ガイド買った！
服	服、雑誌、ゲーム、さきちゃんのプレゼント！|着てた黒い服持ってきて
雑誌	服、雑誌、ゲーム、さきちゃんのプレゼント！|ちょっとルノアールで株の雑誌読んで帰ります
ゲーム	服、雑誌、ゲーム、さきちゃんのプレゼント！|ゲームができる！|ゲームはクリアしたから落ち着くと思います|ボードゲームだと思ったけど、カードゲーム|帰りにゲームかったんだけど|青鬼ってゲームやった！
プレゼント	服、雑誌、ゲーム、さきちゃんのプレゼント！|いいプレゼントあるかなあ？|ラインのプレゼントありがと！|なんかクリスマスプレゼントとかどうとか
ホワイト	ホワイトデーっぽいものじゃないけど、来週渡すね
デー	ホワイトデーっぽいものじゃないけど、来週渡すね
谷間	さきちゃんの昨日の谷間が
頭	頭から離れません|昨日寝過ぎたのか頭痛い|昼頃はわからなさすぎて頭クラクラして過呼吸ぎみだったよ！|頭が軽くいたい|頭身が違う
顔	さきちゃんの顔うつってるので|子供いそうってどんな顔ですかー！？って|好判断なのかな？もう顔知られてるからいいけど
セクシー	セクシーなの欲しいな>_<
保存	これなら保存してもいい？
露出	もうちょっと露出が欲しかった
天気	いい天気！|うん、桜はよさそうだけど天気がね|今日も天気いい！|いい天気すぎて暑いよ！|さきちゃん天気予報的に|おはよ！いい天気|いってらっしゃい！いい天気で爽やかでよかった|東京涼しいけど、明日天気いいといいね|いい天気です！
℃！	伊勢9℃！さむいね
日向ぼっこ	うーん、日向ぼっこかな！
充電	充電切れてた|充電きれそう|過充電くらいだよ！w|充電きれそう、寝てたらおやすみっ|充電切れてた！ふろあがったよー|昼から充電きれてたよー|たぶん充電はきれそ|スマホ充電きれそうです！|充電なくなりましたね！|チケットと充電器はもちまして|充電切れると思うから、午前中には帰るかな！
はみ	はみがきする！
彼岸	お彼岸らしおから
おから	お彼岸らしおから
墓参り	墓参りいってくるね|今日はお墓参り？|お墓参りいってらっしゃい！
誕生	ばあちゃんの誕生日とのことで|母親の誕生日とかで|さきちゃん誕生日おめでと|おおー、となると母親の誕生会とやらに
め	おー、おめでと！|おめでと|さきちゃん誕生日おめでと|おめでとー！！
ダブル	ダブルフェイス？って映画テレビでみてた！
フェイス	ダブルフェイス？って映画テレビでみてた！
テレビ	ダブルフェイス？って映画テレビでみてた！|テレビに三重出身の人出てて|京成船橋がテレビでてる！|レコーダーとテレビは5000円になったよ～
西島	西島秀俊かっこいい！
秀俊	西島秀俊かっこいい！
あや	あやのんがそれはかわいそうw
かわいそう	あやのんがそれはかわいそうw
男	いい男なのか！うれしいけど、会ってどう思われるか不安|男はマストです！|男の脂肪は普通預金、女の脂肪は定期預金だって|次の男とデートするに感じて|他の男と会うのは駄目だよ|すどうさんは男！|他の男の人と話してるのは、あまり気分はよくありませんね|年金の件は役所の土屋さんだか土田さんだか、男の人に聞いたよー
不安	いい男なのか！うれしいけど、会ってどう思われるか不安|そういえば時間言ってたか不安だけど
雨降り	雨降りの庭園も乙な気がしますが
庭園	雨降りの庭園も乙な気がしますが
乙	雨降りの庭園も乙な気がしますが
あら	あらら
間	寝てる間掻きすぎたのか|津と松阪の間とか
左目	左目があかない
眼科	眼科いってきます！
目	なんとなく目も開けられるようになってきたから大丈夫かな|目は開くようになりました|なんだろう！絶対領域しか目に入りません|風呂入る！目が疲れたー|さま！目がつかれたー|目がちかちかします！|少し目がさめた
結膜炎	なんだろう、結膜炎？ものもらい？
らい	なんだろう、結膜炎？ものもらい？|らいんでかける！|あ、でも俺が戸籍謄本もらいに行くとき一緒にもらえばいいや
目薬	とりあえず目薬買います
病院	病院のバイトだっけ？|普通の病院もあるでしょー？|新しい病院はどうだった？|さきちゃんは病院いけた？|補習なかったら所属の病院で勤務って書いてあったような|病院いって聞いてみなきゃね|こんばんは！今日は病院で年越しです|病院待ちです|松江病院まで歩いてきたので一緒にかえろっ|病院前に行きますっ|病院もいっぱい
バイト	病院のバイトだっけ？|お！バイトのだね|そういえば、バイトはいつから？|バイトはある？？|さきちゃんバイトがんば|さきちゃんバイトは火日？|バイトいってらっしゃい|バイトおつかれさま|さきちゃんバイトおつかれさま|さきちゃんバイトおつかれさま！|バイトかっ|さきちゃんバイトいってらっしゃい|さきちゃんバイトお疲れさま！|さきちゃん10日のバイト？|バイトがんば|バイト間に合わないんじゃ|バイトおつかれさまっ|バイトお疲れさま！|今日はバイト？|おつかれだけど、バイトがんばっ
盆栽	桜盆栽|普通の盆栽ほしい！|盆栽！
昇給	来月から昇給だって！
月	月2万上がります|さきちゃん5月は|2月27日から3400回くらいチャットしてますっ|10月の3連休はどうだった？|俺は5月2か6休めそうー
現場	現場と社内の評判がいいからとかなのですが|明日から新しい現場です|新現場はまあまあいい雰囲気です|今日は前の現場の人と飲んで帰るね|前の現場の人の家に泊まります|新しい現場のー|どうも新現場の人たちは|現場のビル前にとめたらあっさり|どうも現場で俺が辞めたがってると噂されてて|明日は定時であがること現場の人に伝えたから|現場の人たちと麻雀やってました！|いい現場だったかなと思いました|新しい現場雰囲気わるいし、あんまりうまくできなくて|今日は現場終わり祝いに外で食べよう！
社内	現場と社内の評判がいいからとかなのですが
評判	現場と社内の評判がいいからとかなのですが
身	全く身に覚えがありません|承太郎そこまで身につけたらもう無敵じゃないですかー！|まったく身に覚えがないから困る|頭身が違う
旅館	旅館松亀です！
松	旅館松亀です！
亀	旅館松亀です！
ショック	さきちゃん3度寝しちゃったん！ショック！
荷物	車に荷物おけるのはありがたいね
ゃんおでかけ	さきちゃんおでかけ？
提示	どうも提示には帰れなさそうだー
春	春は困るね！|春らしくていいね
シャワー	あら、シャワーまだ|シャワーいってらっしゃい！|たぶん1130帰りのシャワー浴びて12時に|シャワー浴びるね|帰ってシャワー浴びたので寝ます！お出迎えできないけど一緒にねよー|シャワー浴びて寝ますね！おやすみ
早起き	あら、さきちゃんも早起き！|早起きでした！
大好き	大好き|俺も大好き|俺も大好きー|俺も大好き！！
日課	お、俺の日課が復活します
復活	お、俺の日課が復活します
足	足を休めましょう|帰りどしゃぶりで足ずぶぬれ|はんぺん足早かった！|足くじいた|足いたと熱少しあったから
殺生	殺生な
面談	面談終わった！|明日は2件面談いってきます|今日は面談ありませんでした！|面談いってきました|今日は面談いってきます|面談終わったー|んー、面談が落とされるのと|うん、面談あるからそのあと帰ります|おととい面談に3人でいって|今日は7時から面談あって、そのあと仕事に戻る予定だから|そろそろ面談終わって家着きます|面談行ってきますね|7:30から面談だから9時くらいになるかも！|また前のバルテックの人と面談一緒だったから
自宅	明日から自宅待機でいいって！
待機	明日から自宅待機でいいって！|はや！待機してます！|クレカがくるので家で待機してます！　|雨降りそうなのでおうち待機|寒いので家待機！|はい！おうち待機！|びさむなのでおうち待機
背景	背景っていうと、プロフィール画像のこと？
プロフィール	背景っていうと、プロフィール画像のこと？
画像	背景っていうと、プロフィール画像のこと？|さきちゃんbetweenのトップの画像変えられるかな？|トップ画像が変わってる！
反映	さきちゃんのほうにも反映されるのか！
csi	csiってなにー？
早め	早めに寝ましょw|さきちゃん寝不足そうだから早めに|早めに寝ます！|おお、俺はちょっと早めに着くかな|でも早めに寝とくね！おやすみ|土曜も出社になっちゃったけど、早めにあがって
クリア	ゲームはクリアしたから落ち着くと思います
寝言	寝言で「緊張する...」って言ってたけど
緊張	寝言で「緊張する...」って言ってたけど|あれは千葉に来るのが緊張するってことだったんだろうかw|明日のバンド発表緊張
...」	寝言で「緊張する...」って言ってたけど
あれ	あれは千葉に来るのが緊張するってことだったんだろうかw
千葉	あれは千葉に来るのが緊張するってことだったんだろうかw|千葉駅で人身事故らしいのでちょっと遅れるかも|10時過ぎに千葉へ帰ります|おお、千葉いないから三重応援しよう|新小岩20分の千葉行き乗ろう
ナース	おお、可愛いナース服|なんだかナース服っぽくはない|おお、普通のナース服！ってかんじ|ナース服∑|ナースさきちゃんあげる！|美人ナース？|そんな美人ナースいたっけ
右	さきちゃん一番右！|ここかなここかなーって右にかちゃかちゃまわせば|バス乗るエスカレーターの右|もうちょっと右
イカ	真イカのパプリカソースに焼肉とハンバーグ|真イカは今日たべてないw|ネット繋がらないのでイカできません！
パプリカ	真イカのパプリカソースに焼肉とハンバーグ
ソース	真イカのパプリカソースに焼肉とハンバーグ|ソースラーメンなんてしりません！
焼肉	真イカのパプリカソースに焼肉とハンバーグ
ハンバーグ	真イカのパプリカソースに焼肉とハンバーグ|ハンバーグ！
ドリンク	あとドリンクバー！|ドリンク含めて一人7000～8000円だろうからちょうどいいかな
バー	あとドリンクバー！|8時からバーの予約取れました|バーいくからいいかなと思いまして
肉じゃが	肉じゃがおいしくできたかな？
andoid	andoidの参考書100ページまでよんだので
参考	andoidの参考書100ページまでよんだので|御徒町がお買い得みたいで参考が
掃除	掃除してた！勉強するっ|とりあえず、2時まで目安にお掃除！|掃除もできたし、でかけてこようかなー|掃除などしましょう|掃除してるけど暑い！|掃除しよう！|さきちゃん掃除中はなそっ|今日は掃除dayです|あとで話しながら掃除しよ|掃除とか！|今日は雨なので掃除します！|家の掃除はしてない|掃除も少し|水、ホットマット、掃除機、ゴミ箱|今日明日で掃除お願いします|お掃除お願いしますね
インストール	たぶんこれインストールすればいけると思う...
胸痛	胸痛であまり進まない
汗	汗は出てないよ！汗出るほどだったら心筋梗塞みたい！
心筋梗塞	汗は出てないよ！汗出るほどだったら心筋梗塞みたい！
ぼけ	俺もぼけっとしときます
簡単	アプリは簡単な画面作れるようになった！|簡単さ！
画面	アプリは簡単な画面作れるようになった！
終電	終電なくなってしもた|終電終バスともに大丈夫です！|絶対終電逃すコースだから|結局できなくて終電で帰りました！|今日は終電くらいになると思う|俺は今日は終電近くになるかなあ|今日からほぼ終電コースになるかなと思います|おーひの終電逃した
上手	あら、上手！
ゅぴた	せーらーじゅぴたー！
セーラー	セーラー水星だね！たぶんw|なんか！セーラームーンっぽいよ！
水星	セーラー水星だね！たぶんw
マーキュリー	マーキュリーか
外	ううん、今は外です！|よねおーひが電話に出なくて外で待ちぼうけ|外も余裕です|外で待ってます|今日は現場終わり祝いに外で食べよう！|外出ております
母親	母親の誕生日とかで|母親の話は話半分に聞いといてください|おおー、となると母親の誕生会とやらに|朝から母親がうるさくてげっそり
姉	姉夫婦と家族でご飯食べようってイベントが発生してます|今日は姉母いるので|明日は姉が出産したので見に行きます|姉夫婦といるととてもつまらない！|それもあるプラス旦那が姉としか話さない|親父からも明日姉らと一緒に花見しよういわれて
夫婦	姉夫婦と家族でご飯食べようってイベントが発生してます|姉夫婦といるととてもつまらない！
イベント	姉夫婦と家族でご飯食べようってイベントが発生してます|イベント応募しようと思って履歴エクスポートしてみました|ただ確実にイベントもらえない！|美術館カップルイベントやってるみたい|イベントステーションの前にいるー
発生	姉夫婦と家族でご飯食べようってイベントが発生してます|こんにちは！手戻りが多々発生してるので
猫	猫なの！|あ、描が猫にみえました
描	あ、描が猫にみえました
ハート	さきちゃんのハートマーク許せません！
マーク	さきちゃんのハートマーク許せません！|ログインマークがでてないというか
ゃんいつでもはなそ	さきちゃんいつでもはなそー
キルラキル	キルラキルみてました|さきちゃんキルラキル見終わったよ|キルラキルだよー
オープニング	オープニングかっこいい！
サビ	サビいい曲！|YouTubeで「藍井エイル　 『サンビカ  --サビver.-』: http://youtu.be/WAYZokHz1L0
曲	サビいい曲！|サンビカいい曲！|好きな感じの曲みつけた！|うんうん、cmでこのバンドの曲流れてて|これも良い曲！|結婚式の曲ぎめしてます
ネット	ネットです！|ネットは繋げられた？|ネット繋がらないのでイカできません！
高田馬場	高田馬場いってきたよー|昨日の高田馬場で決まりました！
たか	たかだのばば
ばば	たかだのばば
早稲田大学	早稲田大学のちかくかな
きゅうじ	きゅうじんあるかな
看護	ん？看護学校か！|看護学校卒業だけで十分な手みやげですよ！！
野田	野田は遠いかも！
松戸	松戸の方に住めばいいかな
皐月	皐月がショートになってる！
ショート	皐月がショートになってる！
北関東	俺はだれだろ、北関東の猿が好きかな！
猿	俺はだれだろ、北関東の猿が好きかな！
船橋	船橋から直通の出てるからそれ乗れば|ということで、船橋から歩いて帰る！|5時前くらいに船橋つきます|船橋からタクシーで帰る|船橋からのバスです|船橋2204とゃく|船橋ぶらついて今から帰るとこ|びとうぃーんの船橋6ど！|船橋7時前にはつきます！|船橋駅で待ち合わせましょう|船橋1845で！|船橋で食べて帰る？|船橋何時になる？|船橋でまってます|船橋で待ち合わせよう！|はい！11時に船橋でいいかな|俺は船橋についたよー|今船橋だけどタクシー並んでる|そしたら船橋10時前くらいだね！|1030船橋です|30に船橋です|京成船橋がテレビでてる！|新小岩にしようか、船橋にしようか|あとで船橋に戸籍謄本とりいく！|なぜかさきちゃんが船橋市いることになってる|今日パスポート受取＋ご飯で船橋駅8時に|船橋にでもいこうかと思うけど
直通	船橋から直通の出てるからそれ乗れば
バス	バスとか含め1時間半はかかりますね|雨降っててバス道こみこみ|バス乗ってて気付かなかったよ|いってきます！バス遅れて遅刻ー|バス電車の遅れだからしょうがなかったよ！|バス逃して別ルートの武蔵野線乗ってるけど|仕事の最寄り駅からバスがいやだからだけど|バスがないのでタクシーで帰る|船橋からのバスです|バス乗った！|バス乗るエスカレーターの右|バス乗ったので帰り11時前です|35分のバスで帰ります|バス乗ったら教えて|ららぱーく後17:45までバス無いから|ららぱーくから大湊行くバスが17:45までありません|54分のバスで帰りますね！|あとバスタオル白色なかったので、さきちゃんちあるかなあ|着いたけど、バス泊まってたとこでいいだろうか？
半	バスとか含め1時間半はかかりますね|4時間半はねましょ！|ね！半くらいに帰るね～
都内	来年はさきちゃんと都内に近いとこに引っ越しましょう|都内でも2K8万とか
制服	いい感じの制服かな！
日月	となると、さきちゃん5月会う日は日月だけど
ゃんはなせるかなっ	さきちゃんはなせるかなっ
続き	続きはやる気ありません！
やる気	続きはやる気ありません！|今日はどうもやる気がありませんでした|今日はなんかまったくやる気がしないー
ブログ	ブログ作ってみた！|新しいブログ！こっち更新しようとおもいます
amphiprion	http://amphiprion.misujitate.com
misujitate	http://amphiprion.misujitate.com
com	http://amphiprion.misujitate.com|http://watergrass0000.wordpress.com
雰囲気	新現場はまあまあいい雰囲気です|新しい現場雰囲気わるいし、あんまりうまくできなくて
通勤	通勤が大変！
先	先寝てて|チャット送れないだろうから先にいっときます|夏見北でーす、先でとまりまーすぅ|ううん、停留所の10めーとる先くらいでとまったよ！|先に帰ってると思うよー|遅くなりそうなので先に食べてもらっても|まっててくれてたの！もちろん、先食べてて|今日は遅くなりそうです。先に食べてて|出ます！先寝てて|先に寝てて|二件目です！先寝ててもよいかと
バンド	バンド組もうと思って|バンド組むために張り紙しようって話になりました|バンドメンバーが4人になりました！|今日はバンドの顔合わせしますっ|バンド練いってきます|バンド練してたから、今から帰るね|バンド練して、そのあと飲んでるときにたべた|バンド演奏してみたんだけど|まだバンド部の下地ができてません|あとほかのバンドのドラムが|今バンド練終わって帰ってます|うんうん、cmでこのバンドの曲流れてて|今日はバンド練があります|バンドでコスプレイヤーの女ボーカルがいて|おとといのバンド練で撮った写真！|髪切ったのでバンド練いきますっ|明日バンド練して帰りますっ|バンドの女の子と|明日のバンド発表緊張|ラーメン食べて、バンド部の集まりいってきます！|おはよう！バンド練行ってきます
ギター	ギター一人いたからあとベースとvocal！|どうもギターの音がばらばらだったみたいです
ベース	ギター一人いたからあとベースとvocal！|その人にベースとボーカル捜しといてっていったので
vocal	ギター一人いたからあとベースとvocal！
ボーカル	その人にベースとボーカル捜しといてっていったので|バンドでコスプレイヤーの女ボーカルがいて
シリウス	シリウスとサンビカやりたいなあ
サンビカ	シリウスとサンビカやりたいなあ|サンビカいい曲！|夜明けのサンビカ　心で歌う♪♪♪|YouTubeで「藍井エイル　 『サンビカ  --サビver.-』: http://youtu.be/WAYZokHz1L0
夜明け	夜明けのサンビカ　心で歌う♪♪♪
心	夜明けのサンビカ　心で歌う♪♪♪|まだ見ぬファンタジー　心に描く！|今日は暖かくて心落ち着く...
♪♪♪	夜明けのサンビカ　心で歌う♪♪♪
YouTube	YouTubeで「藍井エイル　 『サンビカ  --サビver.-』: http://youtu.be/WAYZokHz1L0|YouTubeに6ぎがくらいとられてる|YouTubeで「fox capture plan / 疾走する閃光」を見ませんか - fox capture plan / 疾走する閃光: http://youtu.be/KFstP0C9sVk|"ディヴィニティ：オリジナル・シン　エンハンスド・エディション_20160622002653" を YouTube で見る - https://youtu.be/T-ugBPbFcLw|"FF4　愛のテーマ　ピアノ" を YouTube で見る - https://youtu.be/I2fGXP9RLes
藍	YouTubeで「藍井エイル　 『サンビカ  --サビver.-』: http://youtu.be/WAYZokHz1L0
井	YouTubeで「藍井エイル　 『サンビカ  --サビver.-』: http://youtu.be/WAYZokHz1L0
エイル	YouTubeで「藍井エイル　 『サンビカ  --サビver.-』: http://youtu.be/WAYZokHz1L0
--	YouTubeで「藍井エイル　 『サンビカ  --サビver.-』: http://youtu.be/WAYZokHz1L0
ver	YouTubeで「藍井エイル　 『サンビカ  --サビver.-』: http://youtu.be/WAYZokHz1L0
.-』:	YouTubeで「藍井エイル　 『サンビカ  --サビver.-』: http://youtu.be/WAYZokHz1L0
youtu	YouTubeで「藍井エイル　 『サンビカ  --サビver.-』: http://youtu.be/WAYZokHz1L0|YouTubeで「fox capture plan / 疾走する閃光」を見ませんか - fox capture plan / 疾走する閃光: http://youtu.be/KFstP0C9sVk|"ディヴィニティ：オリジナル・シン　エンハンスド・エディション_20160622002653" を YouTube で見る - https://youtu.be/T-ugBPbFcLw|"FF4　愛のテーマ　ピアノ" を YouTube で見る - https://youtu.be/I2fGXP9RLes|https://youtu.be/8OQaCVMF1zo
be	YouTubeで「藍井エイル　 『サンビカ  --サビver.-』: http://youtu.be/WAYZokHz1L0|YouTubeで「fox capture plan / 疾走する閃光」を見ませんか - fox capture plan / 疾走する閃光: http://youtu.be/KFstP0C9sVk|"ディヴィニティ：オリジナル・シン　エンハンスド・エディション_20160622002653" を YouTube で見る - https://youtu.be/T-ugBPbFcLw|"FF4　愛のテーマ　ピアノ" を YouTube で見る - https://youtu.be/I2fGXP9RLes|https://youtu.be/8OQaCVMF1zo
WAYZokHz	YouTubeで「藍井エイル　 『サンビカ  --サビver.-』: http://youtu.be/WAYZokHz1L0
L	YouTubeで「藍井エイル　 『サンビカ  --サビver.-』: http://youtu.be/WAYZokHz1L0
ファンタジー	まだ見ぬファンタジー　心に描く！|よくわかんないファンタジーみる！
挿入	うん、挿入歌
眠気	電車に揺られ　眠気が襲う|眠気と戦う時間だzzz
びしゃすみたいな	あんびしゃすみたいな
アンビシャス	アンビシャスであってたみたい
運命	運命の糸を　たちきいってそのさきにー
糸	運命の糸を　たちきいってそのさきにー
きい	運命の糸を　たちきいってそのさきにー
亀戸	今亀戸です|亀戸だったら12時くらいかな？|今亀戸だから
ひらい	ひらい、しんこいわ、こいわ、市川、もとやわた、下総中山、西船橋、ふなばし|俺もそれくらい！今ひらい
しん	ひらい、しんこいわ、こいわ、市川、もとやわた、下総中山、西船橋、ふなばし|しんこいわー|しんこいわ！|次しんこいわー|次しんこいわ！|しんきば！
もと	ひらい、しんこいわ、こいわ、市川、もとやわた、下総中山、西船橋、ふなばし
下総	ひらい、しんこいわ、こいわ、市川、もとやわた、下総中山、西船橋、ふなばし
中山	ひらい、しんこいわ、こいわ、市川、もとやわた、下総中山、西船橋、ふなばし
西船橋	ひらい、しんこいわ、こいわ、市川、もとやわた、下総中山、西船橋、ふなばし
タクシー	終バスなさそうだからタクシーかなあ|タクシー|船橋からタクシーで帰る|バスがないのでタクシーで帰る|電車タクシーなので早くなれない|タクシーのったよ|タクシーでかえろう|タクシーとまってるとこがロータリーです！|今船橋だけどタクシー並んでる|タクシー2台で大喜庵へ|しおんしはタクシーでかえるそうでした|なければタクシーで行きます|タクシー捕まらない
節約	節約しなきゃなのに
ゅうばす	1205がしゅうばす
声	さきちゃんの声ききたいです|コース変えて、料理出すタイミングで声かける感じにしました
嫁	しおんちゃんは嫁にするなら最高だね！と
役員	今日は役員の人に
結婚	結婚して子供いそうなくらい|しおん君は結婚しても妥協で可愛くなさそうだよねっていわれてて
子供	結婚して子供いそうなくらい|子供いそうってどんな顔ですかー！？って
余裕	余裕あるようにみえるよって|外も余裕です|今日はいい感じに終わりました少し余裕も出てきたかなー|余裕がありますね
そりゃあ	そりゃあ、来年彼女きてくれますしって思って
彼女	そりゃあ、来年彼女きてくれますしって思って|ぱちおくんも早く彼女を作りましょう|しおんちゃん彼女できたって！|いとうちゃんが彼女|彼女と飲みに行くそうです|おーひ彼女は同い年だった
リアクション	リアクションしときました
君	しおん君は結婚しても妥協で可愛くなさそうだよねっていわれてて
妥協	しおん君は結婚しても妥協で可愛くなさそうだよねっていわれてて
基本	基本よっぱらいだからね
体制	さきちゃんの前でも体制をたもちます
チャット	チャットくらいです|チャットログも残せるみたいだから|チャット送れないだろうから先にいっときます|2月27日から3400回くらいチャットしてますっ|一番チャット回数が多い人にダイヤモンド|Skypeでチャットおくってみたんだけど|さきちゃんとチャットできたから頑張れる気がする！
面倒	そろそろ面倒な人になるので
計算	計算通り
クッキー	クッキー食べたい
浴	浴びたらはなそっ
びたらはなそっ	浴びたらはなそっ
形	形むずかしそ|形きれい！おいしそう
ゃんおはよおおおお	さきちゃんおはよおおおお
営業	本日の営業は終了しました|営業の人とご飯食べてたー
終了	本日の営業は終了しました
ゃんばっちり	さきちゃんばっちり！
てんき	いいてんき！
こんばんは	さきちゃんこんばんは！
水槽	水槽のco2添加キットも自作でできたので
co	水槽のco2添加キットも自作でできたので|http://www.bellesalle.co.jp/room/sankaku/|引っ越し, http://www.amazon.co.jp/registry/wishlist/VBMAP29JAKSH/ref=cm_sw_r_li_awwlo_0nx6ub1937AWS|http://www.ryu-tsu.co.jp/kakaku.html#diamond|http://www.takara-kiho.co.jp/design_ring/design_ring.html
添加	水槽のco2添加キットも自作でできたので
キット	水槽のco2添加キットも自作でできたので
自作	水槽のco2添加キットも自作でできたので
水草	水草も育ってくれるはず
二酸化炭素	ちょこっとだけ二酸化炭素でてますw
絵	ふむ、絵がわかりやすいね
寝不足	さきちゃん寝不足そうだから早めに|寝不足だねー|寝不足！|寝不足解消？
まち	風呂入るので少々おまちください|髪乾かすのですこしおまち|ちょっとおまちを！|みなみすなまち！
いつ	俺あがったからいつでもかけてー|さきちゃんはいつごろだろう？|10時すぎからならいつでも|俺はいつでも話せる！インしてるね|いつでもはなせる！|いつでも話せるけど風呂とご飯があります！|ただいま！いつでも話せるよ|いつくらいになるだろ？|いつでもかけて|俺いつでも話せるからかけて|いつでもはなせます！|22日に来ていつごろまでいる予定かな？|だいたいいつごろになるかな？|ヒーローものなんだ俺はいつでも話せます！|いつでもかけてっ|風呂以外いつでもはなせます|帰ったのでいつでも話せます|ふろあがったのでいつでも！|いつごろ家着くかな？今ルノアールいるので|いつごろつきそう？|さきちゃんいつごろ来るかな？
次元	次元っぽくはないw
清潔	清潔感がありすぎー！
スーパー	俺はスーパーで弁当でも買ってかえろうかな
弁当	俺はスーパーで弁当でも買ってかえろうかな|半額弁当|こんにちは！今日のお弁当もおいしゅうございました|弁当箱も洗えた|お弁当美味でした！|お弁当大変満足でした！
半額	半額弁当|480円の半額が290円...？って思って新小岩のホームから撮っちゃった
給料	給料日だけど！|お給料ふりこまれた！さきちゃんの口座番号と支店なんだろ？|今月のお給料入ったので、さきちゃん口座に振り込みました。
何	さきちゃん何食べる？|何買ったのー？|何か設定変えたくなったらパスワードはpass|何か食べに行こー😔|何か買って帰ろうか？
おなか	おなかいっぱい？|おなかをさすってあげたいです！|おなかはちきれるー
ゃんただいまっ	さきちゃんただいまっ
火	さきちゃんバイトは火日？|火木日かな
木	火木日かな
最悪	さきちゃん今日は寒いよ！最悪！
帰社	帰社日なので帰社します|今日は帰社日だけど|今日は帰社日だけど、話せたらはなそう！|帰社します|今日は帰社日です|今日は帰社日で|俺は明日に備えて、帰社日欠席でかえる！|俺は帰社日なので遅くなりそうだから|今日は帰社してしおんちゃんいたんだけど|帰社日なので少し寄ってから帰ります|帰社しますー
ゃんもおつかれさま	さきちゃんもおつかれさま！
人身	千葉駅で人身事故らしいのでちょっと遅れるかも
事故	千葉駅で人身事故らしいのでちょっと遅れるかも
ツバメ	うーん？ツバメの巣！
巣	うーん？ツバメの巣！
手元	手元移してってかんじかな
実況	実況は難しいね！|実況しよう！っていってたんだけど
会社	しおんちゃんと会社行って|2.会社の今後について|まだ会社なのです！|もうすぐ会社出ます！|上の会社が同じで俺の評価高いみたいだからがんばらねば|今日は会社いきます|会社辞められなさそうだったけど|会社への挨拶も終わったよー
楽器	楽器の練習してきますっ
練習	楽器の練習してきますっ|おそめの運転練習中。晩ご飯いっしょに食べよう！
張り紙	バンド組むために張り紙しようって話になりました
話	バンド組むために張り紙しようって話になりました|母親の話は話半分に聞いといてください|そのあとの話です
ワード	ワードでなんか作ってもらう|退職届にワード使いたいから
センス	しおんちゃんのセンスに期待しますw|さきちゃんセンスで変えちゃってもいいよ！
期待	しおんちゃんのセンスに期待しますw
ジョセフ	ジョセフのおじいちゃんがジョナサンで|じょうたろうのおじいちゃんがジョセフだね
おじいちゃん	ジョセフのおじいちゃんがジョナサンで
ジョナサン	ジョセフのおじいちゃんがジョナサンで|ジョナサンくらいしか思いつかない
ょうたろうのおじいちゃんが	じょうたろうのおじいちゃんがジョセフだね
お父さん	お父さんに∑|お父さん、お母さんに聞いてみて！
ジョジョ	さすがジョジョ(゜o゜;
(	さすがジョジョ(゜o゜;|そんなに驚くの(ﾟoﾟ;|バーベキューすごい(゜o゜;|少しじゃない(゜o゜;|早く復旧するといいね(゜o゜;|(゜o゜;(゜o゜;(゜o゜;
;	さすがジョジョ(゜o゜;|そんなに驚くの(ﾟoﾟ;|バーベキューすごい(゜o゜;|少しじゃない(゜o゜;|早く復旧するといいね(゜o゜;|(゜o゜;(゜o゜;(゜o゜;
みんな	みんな読んでる！|みんな身長170以下だから|進捗みんな遅れてて休出するみたい|みんなうんうんって感じ|みんなとご飯食べて帰るながれかな？|ほぼみんな集まった感じかね
マスト	男はマストです！
太郎	承太郎そこまで身につけたらもう無敵じゃないですかー！
そこ	承太郎そこまで身につけたらもう無敵じゃないですかー！|錦糸町駅が結構好きだからそこがいいなあとは思うけど|あら、もうそこまで|トムズカレーと同じなんだ。そこのラーメン辛そう|自己紹介的なものをそこですることになるのかな|ディズニーはそこまで混んでなさそう？|そこは安心しました
無敵	承太郎そこまで身につけたらもう無敵じゃないですかー！
雨	こっちも雨だー|雨降っててバス道こみこみ|雨大丈夫かな？|雨だー|雨はどうだろ？|おはよ！こっちは雨だー|雨強い！|こんにちは！そこそこ積もってたけど雨になってほとんど溶けてきた|おはよ！雪も雨もふってない|今日は雨なので掃除します！|今日は雨降って寒いのでひきこもることにします！|雨降ってないみたいだから大丈夫！|雨降ってそう？|雨だしね|雨すごいねー|雨落ち着いたらクリーニングお願いします|雨降ってるからきをつけて！|雨降りそうなのでおうち待機|月曜雨は大変だ|雨降ってきたよー|雨は止んだようだね|かえろー。雨はどうだろう？|雨は降ってなさそうだから早く帰るー|雨降ってたら傘を
気温	あれ、こっちは気温あがるみたいだよー|気温見てみると伊勢すごい寒そう|あら、気温更新されてなかったみたい
予約	予約します|さきちゃん5日予約して大丈夫？|了解！予約しちゃうー|予約できた！|18日で予約しちゃっていいかな？|宿の予約もできました！|キャンセルはしておくから、さきちゃん予約してみてー|料理も予約しちゃおう！|だいきあんには浦野で予約してるのかな？|8時からバーの予約取れました
ムーン	なんか！セーラームーンっぽいよ！
ほん	ほんもの！
いそ	いそげっ
帰り	お帰り|帰り道迷走しすぎて帰りが|帰りは12時くらい？|今帰ってます、帰りが1215くらいかな|了解！帰りに振り込みます|帰りにゲームかったんだけど|今から帰ります！帰りに振り込むね|帰りは順調？|3日楽しみ！あれ、帰りは4日？|うん、帰り４日！|帰りに効く薬かってかえるよー|帰り11時すぎます|帰りはたぶん9時くらいの見込みです！|ちょっと残ってるので帰りたぶん9時くらい！|帰りさくっと食べて帰るか、買って帰るよー|今仕事終わってから行くから、帰りは12時すぎるかそれくらいになるかと|帰りは10時過ぎになるかなあ|帰りは10時すぎかと|帰りは8時半ごろ？
ゃんおつかれさまあ	さきちゃんおつかれさまあ
残業	残業だー|残業してそれでも終わらないなら|残業休日ともにほぼないよ！|5月末までは毎日残業になりそう！|残業して帰ります！|残業続きで金曜なみのだけどまだ木曜|おつかれさま！今日はちょっと残業してます|すこし残業して帰るー|残業お疲れさま|残業おつかれさま！|まだ6時台かー、ってくらい残業慣れしてしまってます|おつかれさま！ちょっと残業しましたー|今日は少し残業しますー|おつかれさま！残業あがる！|残業してたのでかえります！|ちょっと残業ちゅう|おつかれさま！今日も残業予定じゃよ|俺も残業中|さきちゃんも残業なかったら一緒にいこー|ちょっとだけ残業したので帰ります！|久々残業
工数	この工数じゃ足りません、時間かかりますっていって
出勤	休日出勤してもいいよと、、、|出勤日を休みにしてなくて逆によかった！|初出勤はまあまあいい感じでした！
切り	切りのいいとこまでやってかえります|切りの良いとこまでやって帰るね|切りが悪いのでもう少しやっていきますっ
神田	今から神田でます
ドミニオン	ドミニオンやる！
電話	よねおーひが電話に出なくて外で待ちぼうけ|電話します！|さきちゃん電話しちゃってた？|明日のことは電話で話そう|さきちゃん見知らぬ電話番号からかかってきたから|休みの日の電話は心臓に悪い！|強くなってたら電話します！|ありゃ、キャンセルの電話今しちゃった！|行くときまた電話するって言っといたから|買ったら電話するねー|やまとの運ちゃんから電話きてたから届けられなかったのかなとか思いまして|うん、珍しく休日に電話キタ
待ちぼうけ	よねおーひが電話に出なくて外で待ちぼうけ
ボード	ボードゲームだと思ったけど、カードゲーム
カード	ボードゲームだと思ったけど、カードゲーム|カード俺持ってます|さきちゃんクリーニングのカード持ってたっけ|クリーニングのカードがないなって。帰ります！|さっきのplay asisで買ったカードだけど、
watergrass	http://watergrass0000.wordpress.com
wordpress	http://watergrass0000.wordpress.com
更新	新しいブログ！こっち更新しようとおもいます|あら、気温更新されてなかったみたい|免許の更新いてきます|更新していきますね
広告	広告なくてデザインすっきりしててよいです
デザイン	広告なくてデザインすっきりしててよいです
ﾟ	そんなに驚くの(ﾟoﾟ;
親	親が入ってて入れてない|親が入ってる|あら、なんか朝から親に同じこと言われてたから|朝方親からメールきてたような...|一応親用のメールさきちゃんにも出しました
調子	どうもスカイプ調子よくなさそうだね|俺は調子微妙だー|あと一日だね！調子はよさそう？|風呂は入れたけどまだ調子もどりません
組み合わせ	素晴らしい組み合わせ
気分	暖かいのであまり帰る気分になりません！|今日は朝からなま暖かく気分良好！|おしゃれなイタリアンなので大人になった気分です！|他の男の人と話してるのは、あまり気分はよくありませんね
高揚	高揚感があります！
GW	GWです
結婚式	明日結婚式でたくさん飲みそうだしw|結婚式いってきます|あと、おそめ結婚式の写真！|結婚式の二次会からなのでこれ3じかいです|おー結婚式だ！|結婚式の曲ぎめしてます
ぱちおくんも	ぱちおくんも早く彼女を作りましょう
夢	さきちゃんにすごい辛いこと言われた？夢をみたよ|とても悲しい夢でした
新郎	新郎の歌です
歌	新郎の歌です
披露宴	いい披露宴でした！|披露宴おわりました！
二次会	二次会もおわりました！|結婚式の二次会からなのでこれ3じかいです|二次会が7時からなので、9時半くらいに帰るかなあ
栄光	栄光の架け橋へとー
架け橋	栄光の架け橋へとー
サイゼリア	サイゼリアでご飯食べて帰るので
成田	親父とばあちゃんで成田に来てます！
題	今日のお題
旅行	1.次の旅行どこ行くか
話題	話題的にもうおっさんだなと実感しました
おっさん	話題的にもうおっさんだなと実感しました
脂肪	男の脂肪は普通預金、女の脂肪は定期預金だって
預金	男の脂肪は普通預金、女の脂肪は定期預金だって
女	男の脂肪は普通預金、女の脂肪は定期預金だって
定期	男の脂肪は普通預金、女の脂肪は定期預金だって
後輩	あと後輩部下の接し方とか|俺部活すぐ辞めてーだから後輩の接し方
部下	あと後輩部下の接し方とか
部活	俺部活すぐ辞めてーだから後輩の接し方
納豆	今日は納豆と刺身にします！
刺身	今日は納豆と刺身にします！
zzz	眠気と戦う時間だzzz|今日は酔ってるというよりとてもねむいzzz
ゲー	無理ゲーです！
手伝い	0.5日で振られてる人がいて、その手伝いです
銀時計	銀時計いるねっ
共有	写真の共有ありがとう！|おー、さきちゃん共有ありがとう|共有|共有というかアルバム？|共有ありがと！|写真共有ありがと|写真共有ありがと！
サラダ	おお、かわいいサラダ！
愛情	愛情が感じられますね！
dvd	dvd返しに行ってたー
ダイエット	すごいダイエットだw
森本	森本かなさん！
腹筋	腹筋と腕が筋肉痛でしたw
腕	腹筋と腕が筋肉痛でしたw|腰と腕が痛いかな|腕の見せ所ですね！
筋肉	腹筋と腕が筋肉痛でしたw|ジムいってきたから2日間は筋肉痛になるかな！
いってき	いってきますっ|仕事いってきますっ
between	さきちゃんbetweenのトップの画像変えられるかな？
トップ	さきちゃんbetweenのトップの画像変えられるかな？|トップ画像が変わってる！
チーク	さきちゃんにチークがつきましたね
ふく	ほんとだ！ふくの模様とかだね
模様	ほんとだ！ふくの模様とかだね
動画	動画もよく撮れてました|家帰って動画みるんだ！|ディズニーの動画みました！よく撮れてる
十分	今のままで十分魅力的な体だよ|看護学校卒業だけで十分な手みやげですよ！！
魅力	今のままで十分魅力的な体だよ
体	今のままで十分魅力的な体だよ
内容	ちゃっとの内容はちょっと見せられないかな！
ログ	チャットログも残せるみたいだから|バンコクオーキッド [食べログ] - バンコクオーキッド
つり	とはいえ、そんながっつりは見せないでしょw
実習	実習おつかれさまのチューしましょう！|＋実習効果？|あら、今日は実習じゃない？|さきちゃんは新しい実習はどうですか？
チュー	実習おつかれさまのチューしましょう！
ここ	ここは消すんだなっ|こことかすごくいいと思いました！|こことか良すぎると思います！|こことかも全然いいなと思いました|ここかなここかなーって右にかちゃかちゃまわせば|ここ結構安いのにいい！|ここでやるみたい！|ここのMD-1|ここのようです|俺もここよくわからない
メンバー	バンドメンバーが4人になりました！|他のメンバーもしーんとなっちゃって|チームメンバーが一人もいなくて仕事が全く進まない状態...
遅刻	いってきます！バス遅れて遅刻ー|遅刻少ししたけど|普通の電車遅延で少し遅刻した！
場所	さきちゃんと住む場所探し中！|場所が一緒でちょうどいいねb|俺もいかなきゃ！場所教えてね|買える場所あったんだ|そしたら場所だけかなあ
K	都内でも2K8万とか
錦糸町	錦糸町駅が結構好きだからそこがいいなあとは思うけど|錦糸町駅にある
夏休み	夏休み思ってたよりみじかめ！|いい夏休みだねー
平穏	平穏な日々はないのか
息抜き	息抜きも大事だよー|土日息抜き！|息抜きか終わったら話そう
大事	息抜きも大事だよー|丁寧大事！|あら順位というより得点大事です！|今日は大事をとって休みました
自社	自社戻ってて今から帰るね|自社の人俺一人だから居心地悪いー
ドラム	ドラム叩いてた人がいてうずうずしてました|あとほかのバンドのドラムが
うずうず	ドラム叩いてた人がいてうずうずしてました
目安	とりあえず、2時まで目安にお掃除！|おはよ！7時半東京目安でお願い|今日も9時頃目安でかえりますー|飲んで帰りますので11時目安になりますっ|俺は11時目安に帰宅かなー
ゴミ	今ゴミ袋8つ！|ゴミは水土でした|洗濯物ほしとツタヤとゴミだしはしたよー|あ、ゴミ出し忘れた！
洋服	洋服は捨てまくりました
史上	さきちゃん史上一番みじかい
後ろ	上は後ろに流してるとかかな？
外出	外出してます！|それとは関係なく書った本読みに外出ました！
サイト	というか、こういうサイトいっぱいあるけど|転職サイトΣいいとこ紹介してもらえるといいね！|カービィのサイトかわいい！
最初	たぶん最初無料でもだんだん
無料	たぶん最初無料でもだんだん
お金	お金取られるパターンだと思うね！|お金があれば冬もこわくない！|マンションのお金は払い込んで|お金振り込みたいのでさきちゃん駅これる？|NTTにお金払ってなくて回線とめられたのか
パターン	お金取られるパターンだと思うね！
バーベキュー	バーベキューすごい(゜o゜;
初日	初日どうでした？
説明	説明だけなのも疲れるよね|27番で説明受ける予定です|説明会おわりました！2時間半くらいかかった
レポート	うん、レポートがんば|レポートがんばってね！|レポートがんばっ
一緒	場所が一緒でちょうどいいねb|しおんちゃんも一緒|それまで一緒にいよう！|ハゲと一緒にいるやつっていわれた|ご飯一緒にたべよー|うん、一緒にねよ|一緒に食べて帰りましょ！|おーひが新小岩にくるようなので晩ごはん一緒にたべよ|松江病院まで歩いてきたので一緒にかえろっ|帰ってシャワー浴びたので寝ます！お出迎えできないけど一緒にねよー|あ、でも俺が戸籍謄本もらいに行くとき一緒にもらえばいいや|明日午前休もらったから一緒に役所いこう|おー、また一緒に見よう|駅で一緒に食べようか？|一緒にかえろう|一緒にかこー|親父からも明日姉らと一緒に花見しよういわれて|さきちゃんも一緒にいきましょ|さきちゃんも残業なかったら一緒にいこー|一緒にいこう！|たぶん6時前に帰るから、新小岩でよねと一緒にご飯食べよー|一緒か！|また前のバルテックの人と面談一緒だったから|一緒にのってこー
b	場所が一緒でちょうどいいねb|自転車快適だよーb
正社員	なんで正社員なのに就活みたいなことしてるんだろう...|正社員の打診がありました
就活	なんで正社員なのに就活みたいなことしてるんだろう...|うんうん、就活しましょ
デメリット	おお、デメリットしか見てなかった
メリット	メリットもありますね！さすがさきちゃん
応募	イベント応募しようと思って履歴エクスポートしてみました
履歴	イベント応募しようと思って履歴エクスポートしてみました
エクスポート	イベント応募しようと思って履歴エクスポートしてみました
確実	ただ確実にイベントもらえない！
回数	一番チャット回数が多い人にダイヤモンド
ダイヤモンド	一番チャット回数が多い人にダイヤモンド
登録	出始めで登録した人には勝てないさ
ぷいんしたよ	すかいぷいんしたよ
厄日	今日は厄日です
ずぶ	帰りどしゃぶりで足ずぶぬれ
面接	面接きらい！|面接お疲れさま！|書類選考2社通って、合わせて面接5社になりました
きらい	面接きらい！
ゲリラ	ゲリラ雷雨的な感じでした！
雷雨	ゲリラ雷雨的な感じでした！
真面目	真面目そうに見えないからだそうです！
泣き	半泣きになったけど、ふっきります
相対	相対的になのかな
愚痴	愚痴でした！さきちゃんありがと|助川さんに愚痴聞いてもらって
たま	たまにはきますっ
ゃんそろそろおつかれさま	さきちゃんそろそろおつかれさま！
ホーム	ホーム上に人が寝ているため|480円の半額が290円...？って思って新小岩のホームから撮っちゃった|ホームまであがれない...
じゅう	ちょっとじゅうでん|じゅうでんきれる！まっててー|じゅうでんきれてる！|じゅうでんきれました
ぷいんしといてっ	すかいぷいんしといてっ
ゃんすかいぷいんできそう	さきちゃんすかいぷいんできそう？
だめ	かけてもだめみたい？|やっぱりWi-Fiじゃだめかなあ|だめっぽいね|ヘルニアでだめそうなのでヘルプで|今日はスタジオだったけど結構だめだしされて|どうも冬はだめだ
Skype	Skypeでチャットおくってみたんだけど|Skypeかからないー|どうやらSkypeさんはWi-Fiだと|Skypeいんしとくね|あがった！Skypeいんしとくね|Skypeかけてみたけどつながらない
..	いってないみたいだね..|あいてるとこあるかなあ..|最寄り駅までめっちゃぬれた..
ゃんおはよよよ	さきちゃんおはよよよ
三井	三井住友とみずほはどっちが好き？
住友	三井住友とみずほはどっちが好き？
みずほ	三井住友とみずほはどっちが好き？
どっち	三井住友とみずほはどっちが好き？|どっちかかなあって|いるかとディズニーどっちだろ？|どっちでもいいです！|どっちがいいかな？|すき焼きかしゃぶしゃぶどっちがいいですか！|どっちも！|お寿司とエールどっちでもよいです！|どっちがいいかな！
貯蓄	貯蓄用口座を作ろうと思いまして
口座	貯蓄用口座を作ろうと思いまして|さきちゃん口座教えて|お給料ふりこまれた！さきちゃんの口座番号と支店なんだろ？|今月のお給料入ったので、さきちゃん口座に振り込みました。
寿司	お寿司いいな！|俺も寿司食べる！|お寿司食べよう（小声）|かっぱ寿司で食べよー、と思ったらめちゃくちゃ混んでた！|お寿司とエールどっちでもよいです！|ご飯まだ作ってなかったら焼き肉かお寿司たべよう
顔合わせ	今日はバンドの顔合わせしますっ|これで顔合わせもばっちりだね
キッス	投げキッスかなと思って使ってみたw
助川	助川さんと須藤さんと飲んでたー|助川さんが研修入るまで|助川さんに愚痴聞いてもらって
須藤	助川さんと須藤さんと飲んでたー
研修	助川さんが研修入るまで
田中	それは田中さんかな！
錦糸	やっぱり錦糸町に住めれば一番便利だけど|今錦糸町だから15分くらいになるかな|今日は定時厳しそうなので明日錦糸町いこう|6時40分くらいに錦糸町かも！|ミニオンズ錦糸町で9時か13時からみれる！|錦糸町いこうか？|錦糸町|錦糸町かな！|錦糸町の時間わかったら教えるね|50分に錦糸町の半蔵門線の改札おねがい！|錦糸町つきました！|錦糸町のJINS！|まもなく錦糸町に到着です|次錦糸町ー|錦糸町から帰りますれ|錦糸町で裾直しとかしてたから今から帰るね！|錦糸町？|今秋葉だから10分後くらいに錦糸町つきます！
便利	やっぱり錦糸町に住めれば一番便利だけど
都営	都営新宿か東京メトロ東西線
新宿	都営新宿か東京メトロ東西線|今から新宿でます！|新宿のまんきつからおやすみ！|ゴールデン街という新宿のいい感じのとこでのんでます！|7時半新宿で！改札はまた決まったら連絡するねー|11時には新宿でるかなと|このまま新宿向かうからそんなに遅くならないと思います|7時には新宿出ますね！
メトロ	都営新宿か東京メトロ東西線
東西線	都営新宿か東京メトロ東西線|東西線で西船乗り換えで総武線で
沿線	沿線でもいいかなと
路線	路線図みながらおもいました
糧	それが今の生きる糧だから|糧になるさ！
ゃんつうわちゅう	さきちゃんつうわちゅう
通話	ラインが通話ちゅうになってた|通話中になっててかからない
ゅうになってた	ラインが通話ちゅうになってた
ガン	ガンダム見てた！面白かったよー|ガンダムだったからいいかなとおもったら|ガンダムの映画が入ってました！|ガンダムみよう！！|ガンダム返しに行きました！ついでに返品にしました
ダム	ガンダム見てた！面白かったよー|ガンダムだったからいいかなとおもったら|ガンダムの映画が入ってました！|ガンダムみよう！！|ガンダム返しに行きました！ついでに返品にしました|キングダム読みながら帰りますー
刺客	13人の刺客面白かった！
お盆	すぐ戻るさ。だが、遅ければお盆に帰る。
迎え火	迎え火炊いて待っててくれ
母	今日は姉母いるので|母！
全員	久しぶりに家族全員家だ
身長	みんな身長170以下だから
巨人	巨人にみえる...w
ぎゅ	ぎゅ！
こめ	こめだきました！|こめだ！
歓迎	歓迎会します！|歓迎会いってきます！|今日は歓迎会なのでご飯いりません！
帰り道	帰り道迷走しすぎて帰りが|帰り道は順調？
迷走	帰り道迷走しすぎて帰りが
乗り換え	一駅で乗り換えなのに降り過ごしたり|東西線で西船乗り換えで総武線で|乗り換えができないね！1030くらいかな？
降り	一駅で乗り換えなのに降り過ごしたり
快速	快速乗って止まらなかったり|快速乗れたからやっぱり10時くらいです！
連絡	寝る準備できたら連絡するね|帰るとき連絡するね|近鉄乗ったら連絡するねっ|電車乗ったら連絡するね|連絡遅くてごめんね|また帰るころ連絡します|あきばで総武線乗ったら連絡するね|げつかで休みだね！とばこくに連絡しなきゃ|はい！連絡しときますね|なんか来てたなあ。連絡してみるね|着く頃連絡するね！北口であいましょ|また帰るとき連絡しますね|7時半新宿で！改札はまた決まったら連絡するねー|保険証も連絡して、また郵送してもらいます！
事務所	事務所には人はいる？|土曜日は区役所も区民事務所もやってなさそう？
安心	なら安心！|そこは安心しました
休み	明日は休みだしゆっくりやすも|休みは素晴らしいね！|明日も休みだからゆっくりしよう|三連休は明日だけ休みだけど|23休みだよー|今日は他の人休みだからなしになった！|風邪ひいたみたいだから今日はお休み中o|そういえばさきちゃん今日休みだったね|今日は休みにしたから迎えにいくね！|休みの日の電話は心臓に悪い！|おお、休み多め|2休みにしよう！|げつかで休みだね！とばこくに連絡しなきゃ|休みなのにいくの|よねらが休みだから会ってきますね|今日は休みにしました！|出勤日を休みにしてなくて逆によかった！
夜光	あと一人が夜光さんっていう、弟分みたいな人！|夜光さんち泊まって帰ります！
弟分	あと一人が夜光さんっていう、弟分みたいな人！
出産	明日は姉が出産したので見に行きます
感心	感心しました
ーバンド	寝過ぎたーバンド練いってきます！
練	寝過ぎたーバンド練いってきます！|バンド練いってきます|バンド練してたから、今から帰るね|バンド練して、そのあと飲んでるときにたべた|今バンド練終わって帰ってます|今日はバンド練があります|おとといのバンド練で撮った写真！|髪切ったのでバンド練いきますっ|明日バンド練して帰りますっ|おはよう！バンド練行ってきます
音	どうもギターの音がばらばらだったみたいです
ばらばら	どうもギターの音がばらばらだったみたいです
ふろ	ふろはいるー|ただいま！ふろはいるー|ふろはいる！|ただいま！ふろはいるよ！|ふろあがったー|ふろあがった！|充電切れてた！ふろあがったよー|ふろあがったからはなせるよ！|おはようふろー|ふろはいった|ふろあがったよ！|ふろあがった|ふろあがったのでいつでも！
ゃんいんしてないようにみえる	さきちゃんいんしてないようにみえる
ジム	ジム寄ってきたよー|ジムいったよ！|ううん、もうジム行って帰るとこ|うん、今日もジム行って|ジムいってきたから2日間は筋肉痛になるかな！|今日も疲れすぎたのでジム行かずに帰るー|ジムいってきたよー|ご飯食べてジムいこう|おかえりご飯食べてジムいきましょー|今日はジムいく？|ジムの申し込みいってきますねー|ジムいくことにするー|ほんならジムいってこよかな！|ジムで泳いできますね
いるか	いるかとディズニーどっちだろ？
ディズニー	いるかとディズニーどっちだろ？|ディズニーからの人でいっぱい！|土曜か日曜ディズニーいこうか|土曜ディズニーいこうか|ディズニーの動画みました！よく撮れてる|ディズニーはそこまで混んでなさそう？
利用	残念！再利用できればいいけど
Wi	やっぱりWi-Fiじゃだめかなあ|どうやらSkypeさんはWi-Fiだと
-	やっぱりWi-Fiじゃだめかなあ|http://www.nagoya-boston.or.jp/event/list/gogo71-76.html|どうやらSkypeさんはWi-Fiだと|YouTubeで「fox capture plan / 疾走する閃光」を見ませんか - fox capture plan / 疾走する閃光: http://youtu.be/KFstP0C9sVk|Blu-rayです！|東京都葛飾区西新小岩1丁目4-1|http://www.ryu-tsu.co.jp/kakaku.html#diamond|ここのMD-1|http://www.takara-kiho.co.jp/design_ring/design_ring.html|http://www.ise-kamimura.jp|三重県 伊勢市一之木3丁目 15-1 美容室アリア|バンコクオーキッド [食べログ] - バンコクオーキッド|"ディヴィニティ：オリジナル・シン　エンハンスド・エディション_20160622002653" を YouTube で見る - https://youtu.be/T-ugBPbFcLw|"FF4　愛のテーマ　ピアノ" を YouTube で見る - https://youtu.be/I2fGXP9RLes|4239-0489-0076|4239-0489-0043
Fi	やっぱりWi-Fiじゃだめかなあ|どうやらSkypeさんはWi-Fiだと
LTE	LTEにしたからかけてみてっ
寝坊	寝坊しかけた！|寝過ぎて寝坊です|寝坊|おはよう！寝坊！
指導	いい指導者さんだー
定時	ばっちり終わらせてほぼ定時で帰りました！|明日は定時であがること現場の人に伝えたから|今日は俺定時にあがる予定だから|今日は定時厳しそうなので明日錦糸町いこう|定時ダッシュ予定だから、新小岩南口6:45位だと思う|定時で帰る！
遅れ	バス電車の遅れだからしょうがなかったよ！
社員	社員が10人以上いる|他の社員に、イケメン二人組！っていわれたよ
漫画	面白くないので漫画喫茶でねます|漫画読んだら帰りますね|漫画少し読んで帰りますね！
喫茶	面白くないので漫画喫茶でねます|マンガ喫茶で勤務表作成してる！
プール	プールで泳いできた！|プールで泳いで疲労してます！
サッカー	さきちゃんサッカー見ながらはなそー|今日日本代表のサッカー録っておいて|サッカーやるみたいだから録画しておいて
姪	姪と会うのは相当少なくなりそう
プラス	それもあるプラス旦那が姉としか話さない|髪切りプラスぶらつきに津田沼いってくるねっ
旦那	それもあるプラス旦那が姉としか話さない
適度	うん、適度にがんばろー
健康	いいなあ、健康的！|健康にもなるし安いしいいかな！
栄養	栄養も満点ですね
満点	栄養も満点ですね
エステ	エステでマッサージしたレベルじゃない∑
マッサージ	エステでマッサージしたレベルじゃない∑
レベル	エステでマッサージしたレベルじゃない∑|なんとか帰れるレベルになったけど|もはやすごすぎて、今まではなんだったのかレベルだ|パンフレットに乗るレベルですね😄
光	光効果！
効果	光効果！|＋実習効果？|温泉効果！
四方八方	四方八方壁のテニスやってきた！
壁	四方八方壁のテニスやってきた！
テニス	四方八方壁のテニスやってきた！
競技	なんて競技かわからなかったけど楽しかったよ
ぐだぐだでした	今日はぐだぐだでしたー
コース	絶対終電逃すコースだから|朝までコースになりました|コース変えて、料理出すタイミングで声かける感じにしました|昨日と同じ11時コースだと思われます|今日からほぼ終電コースになるかなと思います
格好	せっかくの可愛い格好が！|可愛い格好
疲労	プールで泳いで疲労してます！
ムキムキ	そんな早くはムキムキにならないよ！w
店長	店長にセクハラされないようにね
セクハラ	店長にセクハラされないようにね
三重	テレビに三重出身の人出てて|おお、千葉いないから三重応援しよう|三重残念|三重県 伊勢市一之木3丁目 15-1 美容室アリア
出身	テレビに三重出身の人出てて|津出身みたい
人出	テレビに三重出身の人出てて
方言	おー、聞いたことある方言だと思います
微妙	俺は調子微妙だー|俺はそろそろあがりたいけどどうなるか微妙|微妙な気がする
胃	今日は隣の人が責められてて胃がキリキリ
精神	体調はいいんだけどね！精神的に疲れた！
土日	土日ゆっくり休みましょう|土日息抜き！|明日いって土日休みましょ
サキチャンガインシテルヨウ	サキチャンガインシテルヨウに
通り	早く起きようと思ったらいつも通りだったw|さきちゃんいつも通り着きそう？|こっちはいつも通り1115です！少し待ってて|いつも通りだ|のぞみ乗ったのでいつも通りで金時計|いつも通りです！
ルート	バス逃して別ルートの武蔵野線乗ってるけど
武蔵野線	バス逃して別ルートの武蔵野線乗ってるけど
てる	まってる！|まってる
ベルギー	ベルギー勝ちました！|俺の応援してるドイツベルギーはベスト8残ってます
応援	さきちゃんの応援してたカメルーン、イングランドはもういません|俺の応援してるドイツベルギーはベスト8残ってます|おお、千葉いないから三重応援しよう|うん、応援しよう|応援してます！
カメルーン	さきちゃんの応援してたカメルーン、イングランドはもういません
イングランド	さきちゃんの応援してたカメルーン、イングランドはもういません
ドイツ	俺の応援してるドイツベルギーはベスト8残ってます|ドイツがんばれえええ|ドイツかった！
ベスト	俺の応援してるドイツベルギーはベスト8残ってます|ベストキッドわからない！|電熱ベストきになる
nagoya	http://www.nagoya-boston.or.jp/event/list/gogo71-76.html
boston	http://www.nagoya-boston.or.jp/event/list/gogo71-76.html
or	http://www.nagoya-boston.or.jp/event/list/gogo71-76.html
event	http://www.nagoya-boston.or.jp/event/list/gogo71-76.html
list	http://www.nagoya-boston.or.jp/event/list/gogo71-76.html
gogo	http://www.nagoya-boston.or.jp/event/list/gogo71-76.html
美術館	美術館カップルイベントやってるみたい
ぱと	たらこすぱと辛みチキンですゞ
辛み	たらこすぱと辛みチキンですゞ
チキン	たらこすぱと辛みチキンですゞ
並	金曜並のつかれ！|もう出発しました！とうろうの並食べきりました
進捗	進捗みんな遅れてて休出するみたい
臨時	臨時収入ですか
収入	臨時収入ですか
先輩	さき先輩だね|先輩の厳しいチェックですね！
ペット	ペットショップかいてもらお！
ショップ	ペットショップかいてもらお！|オフィシャルショップだけでもいこう！
香り	うんうん、いい香り
かいしゃ	まだかいしゃー
や	やです
びっくり	それはびっくり|さきちゃんもびっくり
クルージング	今日はクルージングいってくるね|クルージングは5時に家出る感じです
船	船！
グラス	俺のグラスじゃないよ！|白ワインのグラスを飲んでます！
だし	明日も仕事だし早く帰らなきゃ！|だし割りができる！|雨だしね|洗濯物ほしとツタヤとゴミだしはしたよー|明日も仕事だし遅くならず帰るね！
すき	すき|俺もすき|すき！|はすきー！
お出かけ	お出かけ？|さきちゃんお出かけ？|明けでお出かけはきびしいから
ラーメン	俺も昼にラーメンたべた！|ソースラーメンなんてしりません！|トムズカレーと同じなんだ。そこのラーメン辛そう|ラーメン食べて、バンド部の集まりいってきます！|豚骨ラーメンたべたい！|ラーメン食べ行く！|ラーメン食べ行く？
自転車	自転車こうた！|自転車快適だよーb|自転車の鍵なくした...|自転車の鍵みつかったよー|自転車だったらあと10分でつくのに！|自転車撤去された！
こうた	自転車こうた！|ハンカチこうた！|これこうた！|macこうた！
最寄り駅	仕事の最寄り駅からバスがいやだからだけど|最寄り駅までめっちゃぬれた..
延長	延長戦だー
制度	そんな制度が
かま	ささかま！
告白	告白！
快適	自転車快適だよーb
丁寧	丁寧大事！
連休	三連休だしがんばろっ|やっぱり3連休あると違うね|10月の3連休はどうだった？|俺も3連休！なにしようか|三連休は明日だけ休みだけど|おはよ！今日がんばれば3連休|一週目3連休中！
DS	3DSかえた？
東京ドーム	今ね東京ドームくらい
きり	きりのいい日数だ|ちょっときりがわるいのでもう少ししたら帰ります
日数	きりのいい日数だ
ラスト	ラスト！
着	着圧ニーハイ
圧	着圧ニーハイ
ニーハイ	着圧ニーハイ
防止	むくみ防止とかのやつかな？
やつ	むくみ防止とかのやつかな？|ハゲと一緒にいるやつっていわれた|ただ中古でだいぶ昔のやつねw|つり下げるやつかなあ|さきちゃん的によさげなやつで！
CM	CMでやってた！
解消	寝不足解消？
みがき	ちょっとはみがき
集中	集中力の限界をむかえたので帰ります
限界	集中力の限界をむかえたので帰ります
西岡	西岡さんかな！
徹夜	明日は徹夜かもしれない|徹夜ですー
地力	地力がついてきたのかな
笑顔	いい笑顔！
左下	左下がさきちゃん！
店	前も食べてたお店だね|でも知らない店だったw|店の前います
まんなか	まんなかさきちゃん！
ダン	ダンヒルのウイスキー？
ヒル	ダンヒルのウイスキー？
ウイスキー	ダンヒルのウイスキー？
予報	さきちゃん天気予報的に
中止	土曜は中止になりそうですね...
楽しみ	うん、楽しみ！|明日楽しみ|いってらっしゃい！楽しみだね|さきちゃんお菓子楽しみだけど|3日楽しみ！あれ、帰りは4日？|さきちゃんに会えるのが楽しみ|おつかれさま！楽しみ|ありがと！楽しみだね|なんと！楽しみ|楽しみです！|楽しみ
ゃんといっぱいいちゃつけるように	さきちゃんといっぱいいちゃつけるように
スマホ	スマホが暴発してました|スマホ見てなかった|スマホ充電きれそうです！|スマホ忘れてたよ！|スマホ忘れてるんだっけ|個別相談終わった！秋葉でスマホ見て帰るねー|スマホの三脚かなー
暴発	スマホが暴発してました
こちら	こちらなんだかんだ遅れなしで普通に空いてました|おはよ！こちら雪が降ってます|こちらです|こちらまだ仕事終わらず|こちらは時間通りという感じです
復旧	早く復旧するといいね(゜o゜;
ゃんおはようれ	さきちゃんおはようれ
Facebook	さきちゃんのFacebookは見れない
判断	好判断なのかな？もう顔知られてるからいいけど
ログイン	ログインしてくれないようです|ううん、自分がログインできない！|ログインはできてるんだけど、緑の点の|ログインマークがでてないというか
自分	ううん、自分がログインできない！|一度言い出したら自分の意見が通るまで言い続ける人だからなあ...|どうも自分のパフォーマンスが出せなかった
緑	ログインはできてるんだけど、緑の点の|さきちゃん緑好き
鍵	自転車の鍵なくした...|自転車の鍵みつかったよー|鍵の手前側だけ上にもちあげるかんじかなあ|ポストにでも鍵入れとくか、さきちゃんだいぶゆっくりめで|郵送して、鍵もらってです！|あと鍵がありません|鍵家におきっぱなのかな
ぱりねますっ	やっぱりねますっ
浦野	浦野家はすごい|だいきあんには浦野で予約してるのかな？
傘寿	ばあちゃんが傘寿なのですが
大雨	とはいえ、大雨で買いに行けないからまたにしますっ
ハンカチ	ハンカチこうた！
敬礼	敬礼！
気合い	おー、気合いはいってる！|気合い入れてこう
チキンライス	チキンライス
きれい	形きれい！おいしそう|きれいに撮れてる！|駅近い南口できれい！|ミラコスタすごくきれい！|うん！きれい！|おー、きれいに書いてもらいましたね|おー、きれい
自由	ようやく自由を勝ち取れるかもしれない！|もうぷらっとこだま買わないで普通に自由席買った方が|自由空間いるのです|自由空間いるから着くころ教えて！
デフォルメ	デフォルメかわいい！
たら	起きてたらはなそっ
リーダー	リーダーがスケジュールひけてないみたいだから
スケジュール	リーダーがスケジュールひけてないみたいだから|結構大変そうなスケジュールだ|まだスケジュールは出てないんだよね？
決勝	残ってるというか決勝か！
戦場	戦場カメラマンの講演会があります
カメラマン	戦場カメラマンの講演会があります
講演	戦場カメラマンの講演会があります
げん	7ギガこえてせいげんかかりました
ぎがくらいとられてる	YouTubeに6ぎがくらいとられてる
音質	高音質がいいで
演奏	バンド演奏してみたんだけど
誰	誰も聞いてなくてかなしかった！
下地	まだバンド部の下地ができてません
ヘルニア	ヘルニアでだめそうなのでヘルプで
ヘルプ	ヘルニアでだめそうなのでヘルプで
ゅ	ちゅー！|しゅーらるーしらない
スペック	スペックみる！
ゃんはなせるときはなそっ	さきちゃんはなせるときはなそっ
サーティワン	サーティワンだ
チョコ	チョコミントと、
ミント	チョコミントと、
紫	紫がコットンキャンディ？
コットン	紫がコットンキャンディ？
キャンディ	紫がコットンキャンディ？
説得	俺が説得する！
手みやげ	看護学校卒業だけで十分な手みやげですよ！！
セット	パソコンのセットアップしてたらこんな時間|ご飯セットなら890円なのでお得かなって
アップ	パソコンのセットアップしてたらこんな時間
ゃんおつかれさまっ	さきちゃんおつかれさまっ
ちい	よねんちいってきます|今度とよはちいこう！|よねんちいこうかと思ったけど帰った！
記	うん、記をつける！
引き	なんて引きの強さ！
無双	ただいま！さきちゃん無双ができるね
バドミントン	安ければバドミントンでもかおうか|バドミントンとなにしよw
肩	肩慣らせたから活躍できるね！
活躍	肩慣らせたから活躍できるね！
もしゃ	俺もしゃわー
追加	写真追加しようとしたけどわからなかった！
パス	パス認証は切ってあるけど
認証	パス認証は切ってあるけど|なんか認証中とかかもしれないから、さきちゃんは買わないでおいて
設定	何か設定変えたくなったらパスワードはpass|新しい端末のほう設定しました！
パスワード	何か設定変えたくなったらパスワードはpass
pass	何か設定変えたくなったらパスワードはpass
撤去	自転車撤去された！
ビル	現場のビル前にとめたらあっさり|こんにちは！リクルートのビルすごい
リッチ	リッチだ！
麻雀	麻雀する！|現場の人たちと麻雀やってました！|昨日は麻雀をやろうと奔走したけど|マリック見ました！麻雀して帰ります|同僚と麻雀やってます|よねらと麻雀してました！帰ります|麻雀勝ち続けてるので、負けたら帰るね
朝飯前	朝飯前さ
打ち合わせ	打ち合わせ早かったね
茶色	俺は茶色好き|そうかな！なぜか茶色ばかり着たり買ったりしてしまう
ゃんあとではなそっ	さきちゃんあとではなそっ
墓	墓参ります
快晴	快晴！
G	Gが出ました...ブラックキャップ買いにいきます|0.341　G　VS2　3EX H&C　90,330円　GIA鑑定書付 ○
ブラック	Gが出ました...ブラックキャップ買いにいきます
キャップ	Gが出ました...ブラックキャップ買いにいきます
効率	効率はよくなるはず
アプデ	アプデでスタンプふえた！
噂	どうも現場で俺が辞めたがってると噂されてて
門前仲	門前仲町でのりかえね
西船	東西線で西船乗り換えで総武線で
総武	東西線で西船乗り換えで総武線で|あきばで総武線乗ったら連絡するね
キッド	ベストキッドわからない！
ぁいわるい	わいふぁいわるい！
カン	カンフー！
フー	カンフー！
花	お花が可愛いですね！
おかし	いとおかし
絵柄	あら、いつもと絵柄が違う
だい	難しそうなおだい！
防寒	防寒着を昨日から必死で探してるけど|ﾜｰｸﾏﾝの防寒具はコスパよし
必死	防寒着を昨日から必死で探してるけど
インナー	インナーはベルメゾンのホットコットが一番みたい|買ったベルメゾンのインナー着てみたけど
ベルメゾン	インナーはベルメゾンのホットコットが一番みたい|買ったベルメゾンのインナー着てみたけど
ホットコット	インナーはベルメゾンのホットコットが一番みたい
ゴア	ゴアテックのマウンテンパーカーがアウターはよい
テック	ゴアテックのマウンテンパーカーがアウターはよい|また前のバルテックの人と面談一緒だったから
マウンテン	ゴアテックのマウンテンパーカーがアウターはよい
パーカー	ゴアテックのマウンテンパーカーがアウターはよい
アウター	ゴアテックのマウンテンパーカーがアウターはよい
ﾜｰｸﾏﾝ	ﾜｰｸﾏﾝの防寒具はコスパよし
コスパ	ﾜｰｸﾏﾝの防寒具はコスパよし|これとかすごいコスパいい
電熱	電熱ベストきになる
窓	家では窓にぷちぷちはって、床は100きんの|うち換気のため窓あけてます！|三階の窓の椅子に座ってるね😃
ぷちぷちはって	家では窓にぷちぷちはって、床は100きんの
床	家では窓にぷちぷちはって、床は100きんの
コルク	コルクタイルしきつめます
タイル	コルクタイルしきつめます
別	別の日にしましょう|別のdiskいれられてました|やっぱり別で探そうかな
遅延	普通の電車遅延で少し遅刻した！|混んでたけど遅延なく間に合いました
ゃんおつけれさまさま	さきちゃんおつけれさまさま！
次	そうそう次は18日に会いましょう！|次の男とデートするに感じて|仕事が次から次にな降ってくる|しおんちゃんは次のデートどうするかしか考えてなかったw|次は新小岩です|次は新小岩！|次は市ヶ谷市ヶ谷|次錦糸町ー|次平井だから、北口であいましょ
jalan	http://www.jalan.net/us/usp3000/usw3001.do?yadNo=327592
net	http://www.jalan.net/us/usp3000/usw3001.do?yadNo=327592|http://hlo.tohotheater.jp/net/schedule/029/TNPI2000J01.do#showing_schedule
us	http://www.jalan.net/us/usp3000/usw3001.do?yadNo=327592
usp	http://www.jalan.net/us/usp3000/usw3001.do?yadNo=327592
usw	http://www.jalan.net/us/usp3000/usw3001.do?yadNo=327592
do	http://www.jalan.net/us/usp3000/usw3001.do?yadNo=327592|http://hlo.tohotheater.jp/net/schedule/029/TNPI2000J01.do#showing_schedule
?	http://www.jalan.net/us/usp3000/usw3001.do?yadNo=327592
yadNo	http://www.jalan.net/us/usp3000/usw3001.do?yadNo=327592
=	http://www.jalan.net/us/usp3000/usw3001.do?yadNo=327592|引っ越し, http://www.amazon.co.jp/registry/wishlist/VBMAP29JAKSH/ref=cm_sw_r_li_awwlo_0nx6ub1937AWS
ＪＲ	ＪＲ総武線/新小岩 歩8分
総武線	ＪＲ総武線/新小岩 歩8分|総武線各駅は平常運転になってるけど|総武線とまりまくりで萎えー|総武線のりました！
新小岩	ＪＲ総武線/新小岩 歩8分|新小岩！|新小岩の家にきました|新小岩にしようか、船橋にしようか|俺は50分新小岩くらいだからさきちゃんもちょうどいいかな？|新小岩着く時間わかったられんらくするから|おわりました！45分新小岩おねがい|新小岩の何時つきそう？|俺11時5分くらいに新小岩着です|新小岩40分です！南口降りるねー|今新小岩ついたのです！|50分新小岩です！|21乗ったら新小岩何分？|新小岩何分？むかえにいきますっ|おーひが新小岩にくるようなので晩ごはん一緒にたべよ|次は新小岩です|新小岩何分だろー？|たぶん俺620に新小岩くらい！|新小岩いるので着きそうになったらおしえてね|新小岩なのでもう帰ります|新小岩何分だろ|480円の半額が290円...？って思って新小岩のホームから撮っちゃった|明日3時新小岩になりました|新小岩駅いるから着く頃教えてねって|新小岩駅にいるので、終わったら教えて|俺23時ぐらいに新小岩|次は新小岩！|さきちゃん新小岩何時になりそう？|新小岩何分だろ？|新小岩かえります！|俺はたぶん55分新小岩とか|定時ダッシュ予定だから、新小岩南口6:45位だと思う|ぎりぎりそうだから新小岩で待ち合わせましょー|おつかれさま！新小岩15分後くらいかなー|こっちは新小岩着くのは5時35分ごろです|新小岩で切符かう|30前に新小岩かなあ|新小岩ぶらついてます|新小岩ついたよー|俺はたぶん新小岩7時45分くらいかと|新小岩で！|新小岩30分でよいかなー|たぶん6時前に帰るから、新小岩でよねと一緒にご飯食べよー|新小岩20分の千葉行き乗ろう
歩	ＪＲ総武線/新小岩 歩8分
℃	伊勢11℃になってたー|この時間で12℃あって最高16℃
さら	さらうどんだね
うどん	さらうどんだね|すがきやうどんがあったのでたべました！|うどんなら食べれそうだーと思って
きば	あきば！|あきばで総武線乗ったら連絡するね|しんきば！|あきばのブックカフェきたー|あきばで本買ってかえりますねー
フォト	フォトフレーム高いと思ってたんだろなあ
フレーム	フォトフレーム高いと思ってたんだろなあ
次男	次男ね！
領域	なんだろう！絶対領域しか目に入りません
台風	ううん、台風近付いてるから|台風一過！|はい！さきちゃんも台風気を付けてね|17日鹿児島台風かも
一過	台風一過！
うま	うま！
;(	(゜o゜;(゜o゜;(゜o゜;
ネクタイ	昨日からスーツはジャケット、ネクタイです
お好み焼き	おお、お好み焼きいいねっ
イングレス	イングレス！
北海道	北海道はがちらしい！
勝ち	勝ち目がみえた！
day	今日は掃除dayです
ゃんいんしたらかける	さきちゃんいんしたらかける！
絨毯	絨毯は引き終わりました
fox	YouTubeで「fox capture plan / 疾走する閃光」を見ませんか - fox capture plan / 疾走する閃光: http://youtu.be/KFstP0C9sVk
capture	YouTubeで「fox capture plan / 疾走する閃光」を見ませんか - fox capture plan / 疾走する閃光: http://youtu.be/KFstP0C9sVk
plan	YouTubeで「fox capture plan / 疾走する閃光」を見ませんか - fox capture plan / 疾走する閃光: http://youtu.be/KFstP0C9sVk
疾走	YouTubeで「fox capture plan / 疾走する閃光」を見ませんか - fox capture plan / 疾走する閃光: http://youtu.be/KFstP0C9sVk
閃光	YouTubeで「fox capture plan / 疾走する閃光」を見ませんか - fox capture plan / 疾走する閃光: http://youtu.be/KFstP0C9sVk
:	YouTubeで「fox capture plan / 疾走する閃光」を見ませんか - fox capture plan / 疾走する閃光: http://youtu.be/KFstP0C9sVk|12:11だよ|定時ダッシュ予定だから、新小岩南口6:45位だと思う|入場:one love 退場:gutsはいい感じな気がする|ららぱーく後17:45までバス無いから|ららぱーくから大湊行くバスが17:45までありません|http://hiygia.mydns.jp:8000/bot/|チェックイン18:30|近鉄も乗れた！12:23着予定です|JR新橋駅の烏森口に19:20でお願いします！|7:30から面談だから9時くらいになるかも！|ぎりぎり座れた...17:27着予定です|17:59着のでいきます|17:30までですよ！|19:15くらいに帰る～
KFstP	YouTubeで「fox capture plan / 疾走する閃光」を見ませんか - fox capture plan / 疾走する閃光: http://youtu.be/KFstP0C9sVk
C	YouTubeで「fox capture plan / 疾走する閃光」を見ませんか - fox capture plan / 疾走する閃光: http://youtu.be/KFstP0C9sVk|0.341　G　VS2　3EX H&C　90,330円　GIA鑑定書付 ○|0.346　F　SI1　3EX H&C　89,570円　○
sVk	YouTubeで「fox capture plan / 疾走する閃光」を見ませんか - fox capture plan / 疾走する閃光: http://youtu.be/KFstP0C9sVk
cm	うんうん、cmでこのバンドの曲流れてて|引っ越し, http://www.amazon.co.jp/registry/wishlist/VBMAP29JAKSH/ref=cm_sw_r_li_awwlo_0nx6ub1937AWS
検索	良さげ！っておもって検索したw
体感	体感あまりかわらない
かわら	体感あまりかわらない
さや	さやちゃん？
欠席	俺は明日に備えて、帰社日欠席でかえる！
ぼう	ねぼう
ぱ	8000円がぱーになった|内宮今出たので、ららぱーく5時とかかなあ|ららぱーく後17:45までバス無いから|今からららぱーく向かいます|ららぱーくから大湊行くバスが17:45までありません|ららぱーく|ららぱーくまできてもらえると
おねがい	いつもどおりでおねがい！|おねがい|おわりました！45分新小岩おねがい|開封前もおねがい！|50分に錦糸町の半蔵門線の改札おねがい！|おねがい！
逆	たぶん逆にはやくつきそう|逆ですね！|アルカキットの逆！|出勤日を休みにしてなくて逆によかった！
ぷらっとこだま	もうぷらっとこだま買わないで普通に自由席買った方が
ゃんぽじてぃぶ	さきちゃんぽじてぃぶ！
のぞみ	のぞみ乗ったのでいつも通りで金時計
こだま	こだま乗れた！
幸せ	昨日今日も楽しかったよ！幸せでした
腰	腰と腕が痛いかな|ふむふむ、引っ越しの用意しなきゃだけどどう腰が重い
クリーニング	今日はクリーニングとりにいくので早くあがりました|クリーニングいってきてから30分後くらいでいい？|クリーニングいってきました！食べ終わったらはなそ|雨落ち着いたらクリーニングお願いします|さきちゃんクリーニングのカード持ってたっけ|クリーニングのカードがないなって。帰ります！
プリクラ	でもプリクラは心臓に悪い
心臓	でもプリクラは心臓に悪い|休みの日の電話は心臓に悪い！
手	明日は少し手を抜きます|手でブルーリング！！|こんにちは！手戻りが多々発生してるので
疲れ	昨日帰ってないからスーツだし疲れがたまってる
ゃく	船橋2204とゃく
桜ヶ丘	桜ヶ丘2230ちゃく|ちなみにうちは団地入口か桜ヶ丘です
コス	バンドでコスプレイヤーの女ボーカルがいて|俺どんなコスプレ似合いますかねえ！？って聞いたんだけど|なんかコスプレ向きじゃないんだなと少ししょげた|コスプレだ！
プレイヤー	バンドでコスプレイヤーの女ボーカルがいて
プレ	俺どんなコスプレ似合いますかねえ！？って聞いたんだけど|なんかコスプレ向きじゃないんだなと少ししょげた|コスプレだ！
他	他のメンバーもしーんとなっちゃって|他の男と会うのは駄目だよ|今日は他の人休みだからなしになった！|他の社員に、イケメン二人組！っていわれたよ|他の男の人と話してるのは、あまり気分はよくありませんね|他は探せそう？
セフィロス	しおんちゃんはセフィロスでいいんじゃない？って
ff	そしたらffがいいんじゃって
塾	みなさん塾考をかさねたけっか
考	みなさん塾考をかさねたけっか
けっか	みなさん塾考をかさねたけっか
レオ	俺はレオ？でいいんじゃみたいな
ハゲ	ハゲと一緒にいるやつっていわれた
レノ	レノ！|さきちゃんイリーナ、俺レノにしよう
イリーナ	イリーナ|金髪の子がイリーナ|さきちゃんイリーナ、俺レノにしよう
機会	する機会があればしよう！|またの機会に！
コミケ	来年のコミケいくか！ってしおんちゃんには言っておいた
む	ふむむ|む！|かにばりずむ！|んーむ
金髪	金髪の子がイリーナ
子	金髪の子がイリーナ|可愛い子だ|子作りですかね！
ゃんねちゃうる	さきちゃんねちゃうる
キャッシュカード	うん、キャッシュカードにかいてある
支店	支店名はなんだろ？|お給料ふりこまれた！さきちゃんの口座番号と支店なんだろ？
お菓子	さきちゃんお菓子楽しみだけど
駄目	他の男と会うのは駄目だよ
失礼	失礼しました
はやとちり	なら良いです！はやとちり|俺もはやとちりでごめんね
ツイッター	ううん、ツイッターわかりにくい！
ごめん	俺もはやとちりでごめんね
神奈川	神奈川から来てくれるんだ
八重洲	八重洲口に待ち合わせましょう|俺は八重洲口ついた！
中央	中央南口にいた|中央改札出て左前いったとこにある|中央西口と西口があるからね
南口	中央南口にいた|駅近い南口できれい！|新小岩40分です！南口降りるねー|南口いくね|南口でまつよ！|南口でおりる！|さきちゃん南口で！|南口で会おう|南口着いた|南口でまちます！|南口おりた！|南口いきます！|南口改札でて、斜め左の入口から地下へ|定時ダッシュ予定だから、新小岩南口6:45位だと思う|南口で待ち合わせよう|南口いくー|南口のmoopa寄って帰ります|南口かな？|南口？|南口改札であおう|8時に南口で待ち合わせましょ～|55分に南口でお願いします！|南口行くねー
すてき	いつもすてきな写真ありがとう|すてきですね
アカウント	おお、昨日あげたアカウント？
ごはん	ごはんたべる|ごはんたべた|ごはんたべた！|おーひが新小岩にくるようなので晩ごはん一緒にたべよ|晩ごはんなーに？|炎丸で晩ごはん|えんまるで晩ごはん兼読書してるけど|今日は晩ごはん社食で食べたから大丈夫！|晩ごはん食べてないけど|ごはんおいしゅうございました！|ごはんあるかな？
系	ほめ殺す系男子
男子	ほめ殺す系男子
つけ	ううん、つけめん！|クーラーつけっぱなしでした😅
めん	ううん、つけめん！|らーめん食べて帰りました！
親子	さきちゃんは親子丼！|今日は親子丼にしよう
丼	さきちゃんは親子丼！|今日は親子丼にしよう|食堂で牛丼食べてみたけど、味は別にふつー
ぷいっぱい	すたんぷいっぱい！
ブルー	手でブルーリング！！
リング	手でブルーリング！！
武将	ううん、俺も武将討ち取るのに忙しかったから
おし	なんかおしゃれなとんかつだ
ゃれなとんかつだ	なんかおしゃれなとんかつだ
スタジオ	今日はスタジオだったけど結構だめだしされて
びとうぃ	びとうぃーんの船橋6ど！
カイロ	さきちゃんカイロ！
ゃんもおつかれさまっ	さきちゃんもおつかれさまっ
ょれ	ぼじょれー！
リー	リーガルハイスペシャルやってるね
ガル	リーガルハイスペシャルやってるね
ハイ	リーガルハイスペシャルやってるね
スペシャル	リーガルハイスペシャルやってるね
おしゃれ	おしゃれ！|おしゃれなイタリアンなので大人になった気分です！|ふむふむ、なんかおしゃれな感じで落ち着くのがいいのかなと！|おしゃれなとこで飲んでますね！
あわ	追いかけてみてるならあわないね！
美人	美人ナース？|そんな美人ナースいたっけ
舞浜	親父を舞浜まで送ってばあちゃんちきました！
嫁さん	お嫁さんとはどうなのって言われました
がき	すがきや！|すがきやうどんがあったのでたべました！
disk	別のdiskいれられてました
スパロボ	スパロボかって、さらっとディスク確認して
ディスク	スパロボかって、さらっとディスク確認して
確認	スパロボかって、さらっとディスク確認して|動作確認はしといたほうがいいかもね
Blu	Blu-rayです！
ray	Blu-rayです！
めんどう	ただ変えに行くのがめんどう
ついで	ガンダム返しに行きました！ついでに返品にしました
返品	ガンダム返しに行きました！ついでに返品にしました
転職	転職サイトΣいいとこ紹介してもらえるといいね！
補習	補習なかったら所属の病院で勤務って書いてあったような
所属	補習なかったら所属の病院で勤務って書いてあったような
勤務	補習なかったら所属の病院で勤務って書いてあったような|マンガ喫茶で勤務表作成してる！
先導	俺が先導します
送別	送別会！|10時から送別会してた|今日も送別会なくなったから普通に帰るー|今日は急遽プロジェクトの送別会が入ったので|9時には送別会終わるからそのあと帰るね
あめ	あめふってるー|今日もあめー
進み	進みはどうでしょ？|今日も遅くなりそうです...進みがとてもわるい
温泉	早く温泉であったまらなきゃ！|温泉効果！|温泉入ってきますね！
帰宅	今から帰宅します|早くて帰宅10時だとおもう|11時ごろに帰宅します|おつかれさま！たぶん10時くらいに帰宅します！|俺は11時目安に帰宅かなー|帰宅中なので11時半には帰ります！|おはよ！俺は8時10ごろ帰宅よていです|おつかれさま！帰宅中|俺も帰宅中|12時頃帰宅します|9時半には帰宅できるように帰る！|ケバブかって帰るんや！昨日と同じ11時頃帰宅予定です|10時頃帰宅かな|今帰宅中なので7時15分ごろかなあ|11時頃帰宅予定です
意味	ほお、なんだか意味深な|意味がわかったらすごい！
提出	うんうん、明日提出しよう
年収	すごくいいね！俺より年収高い
課題	ううん、学校で新しい課題出されていけないよー
遠回り	東京ちょっと遠回りになるから
改札	中央改札出て左前いったとこにある|改札出て左いって、|はい！北口改札でまってるね|パルコ側の改札いるね|改札出て|改札でまつよ！|改札の内側いるね|50分に錦糸町の半蔵門線の改札おねがい！|改札の中いるよー|南口改札でて、斜め左の入口から地下へ|改札いるよー|後楽園駅の改札にしよう|春日通り方面改札います！|改札違ったらそっちいきますね|なんて改札だろ？|はい！北口改札で|南口改札であおう|改札いますねー|7時半新宿で！改札はまた決まったら連絡するねー|北口改札いますね！
像	像のとこいるね！
うえ	ちょっとうえにもちあげて
ゃかちゃまわせば	ここかなここかなーって右にかちゃかちゃまわせば
あく	あくとおもう！
ひだり	あけるのはひだりか！
ひつ	慣れがひつようでさ
手前	鍵の手前側だけ上にもちあげるかんじかなあ
かん	鍵の手前側だけ上にもちあげるかんじかなあ
可能	そうなる可能性も,,,|俺の方が早く帰る可能性
,,,	そうなる可能性も,,,
到着	ちなみに俺は1936到着予定|まもなく錦糸町に到着です
各駅	総武線各駅は平常運転になってるけど
長旅	長旅おつかれさま
ポスト	ポストにでも鍵入れとくか、さきちゃんだいぶゆっくりめで
ゃんだいぶゆっくりめで	ポストにでも鍵入れとくか、さきちゃんだいぶゆっくりめで
お待ち	なら、少しのお待ちで大丈夫かも！|しばしお待ちを
いっこ	いっこくどう！
奔走	昨日は麻雀をやろうと奔走したけど
よね	今日はよねたちと忘年会します！|よねらと麻雀してました！帰ります|よねらが休みだから会ってきますね
忘年会	今日はよねたちと忘年会します！
出社	26まで出社だよー|土曜も出社になっちゃったけど、早めにあがって|今日は10時出社だったので、もう少しやって帰りますー
改行	すごい改行した！
ロータリー	ロータリーで待ってる|タクシーとまってるとこがロータリーです！|ロータリーのとこいますね
エスカレーター	バス乗るエスカレーターの右|丸ノ内線はエスカレーターあがってすぐだった気がする
お願い	ご飯お願いします|迎えお願い|おはよ！7時半東京目安でお願い|そっか！対応お願いします|お願いします|雨落ち着いたらクリーニングお願いします|たぶん10時伊勢市駅でお願いする感じかな|北口お願い|はい！お願い！|お願いします！|お願いします！遅くなってもいいなら買ってかえるよー|水受け取りお願いします|うん、お願いします！|振り込みはお願い|9時半ごろにはあがるので、ご飯お願いします|源泉徴収票お願いします！|帰るの7時45分ごろです！降ってたらお願い|お風呂お願いしたいです！|帰りましたが、お兄さんとお話し中のようですが俺がいること悟られないようお願いします！|はい！西口にお願いします|45分お願いします！|帰りますので45分くらいにお迎えお願いします|JR新橋駅の烏森口に19:20でお願いします！|55分に南口でお願いします！|粗大ごみお願い！|今日明日で掃除お願いします|お掃除お願いしますね|お迎えお願いします！|お風呂だけお願いします
パスタ	パスタおいしい！|あら、パスタたべたかった|ヴィアマンマってとこでパスタ食べたので帰ります！|冷凍のパスタでも大丈夫です！
カフェ	普通にいいカフェだし人気でそう|akbカフェとガンダムカフェは隣みたいだね！|あきばのブックカフェきたー|秋葉のブックカフェで本よんで帰りますねー
人気	普通にいいカフェだし人気でそう|人気店だったんだー
じん	じんさんめあて！
塩	塩対応！
対応	塩対応！|そっか！対応お願いします|おお、対応ありがと|nhk対応です
遊び	同期の家に遊びにいってました！
鬼	青鬼ってゲームやった！
クリ	普通にしないで全クリしちゃいました
ティー	フワッティー少しみたよー
はんぺん	はんぺん足早かった！
むむ	うむむ？|うむむ|むむ！
せき	せきちか！
ちか	せきちか！|俺はばあちゃんちから今帰ってます
お子さん	おお、お子さんがなんにんか
暖	寒いけど暖パン＋ジーンズはけば
パン	寒いけど暖パン＋ジーンズはけば|パンこうてきたから食べるんじゃ|パンこうてかえる！
ジーンズ	寒いけど暖パン＋ジーンズはけば
津田沼	髪切りプラスぶらつきに津田沼いってくるねっ|津田沼に買い物にいきます！
フード	髪切ってフードプロセッサー買えた
プロセッサー	髪切ってフードプロセッサー買えた
アマゾン	アマゾンは4800円だったけどね|アマゾンの欲しいものりスト|アマゾンが届くので|アマゾンは届いてたかなあ
ペガサス	さきちゃんペガサス
エッチ	いきなりエッチな！
年越し	こんばんは！今日は病院で年越しです
岡山	岡山にノートパソコン持ってきてるんだけど
ノート	岡山にノートパソコン持ってきてるんだけど|秋葉で中古ノートパソコン買おうか悩んでます
雪	雪はすごいよ！|雪すごい降ったよ|雪降ってて新幹線遅れてるから|おはよ！こちら雪が降ってます|雪降ったら休もう|おはよ！雪も雨もふってない|雪結構降ってたけど積もってない|雪はすごい降ってる！|おはよ！雪ふってるよおお
意識	意識はまだ戻ってない
状態	このままの状態なら3日はいくよ|チームメンバーが一人もいなくて仕事が全く進まない状態...
正月	さきちゃんは正月なにしてる？|正月っぽい！
雑煮	お雑煮たべる！
雪だるま	夜雪だるまつくったw
相続	相続は大変だねえ、さきちゃん
端っこ	端っこの方でご飯食べよ！
カルタ	カルタなら大丈夫かな？百人一首苦手！
百人一首	カルタなら大丈夫かな？百人一首苦手！
苦手	カルタなら大丈夫かな？百人一首苦手！
満員	新幹線も満員
近鉄	近鉄乗ったら連絡するねっ|近鉄も乗れた！12:23着予定です
特急	特急乗ります！|急行も混みんでて特急も売り切れ
実家	ご実家！うんうん、待ってもらわなくてよかったw|実家着いて車あれば
満悦	どの写真もさきちゃんかわいく映っててご満悦
風邪	風邪ひいたみたいだから今日はお休み中o|また風邪気味、、、薬飲んでねます！|風邪でタウン寸前|風邪で休んでるー、あんまりよくならない|風邪薬ものまないと|どうも風邪っぽい|風邪薬あります！
良好	今日は朝からなま暖かく気分良好！
-..	落ち込みました-..
ネガティブ	どうもネガティブになるので気持ち切り替える！
気持ち	どうもネガティブになるので気持ち切り替える！|それは気持ち悪い
女の子	バンドの女の子と
地獄	進んでもまた地獄のような難しさ
行き帰り	ただ行き帰りは多少楽になったかな
楽	ただ行き帰りは多少楽になったかな
呼吸	昼頃はわからなさすぎて頭クラクラして過呼吸ぎみだったよ！
休憩	昼は休憩ちゃんと取れるけどご飯は喉通らなかった|ので、小休憩とって毎回甘いコーヒーのんでました
喉	昼は休憩ちゃんと取れるけどご飯は喉通らなかった|喉腫れてますねー、次ーって感じで|喉の薬もらって終わりました
コーヒー	ので、小休憩とって毎回甘いコーヒーのんでました|コーヒー一杯500円もするんだけど
スマ	あれ、スマホ変えたの|あら、スマホあったんだ
ホ	あれ、スマホ変えたの
ざんねん	ざんねん！
mac	macこうた！
中古	ただ中古でだいぶ昔のやつねw|中古でも35000円だ|秋葉で中古ノートパソコン買おうか悩んでます
ぱつすごい	いっぱつすごいw
資格	あとは資格試験だけだね
試験	あとは資格試験だけだね
タウン	風邪でタウン寸前
寸前	風邪でタウン寸前
早寝	さきちゃん早寝
ベイ	ベイマックスは楽しかったかな？帰ったら感想聞かせてねっ
マックス	ベイマックスは楽しかったかな？帰ったら感想聞かせてねっ
感想	ベイマックスは楽しかったかな？帰ったら感想聞かせてねっ
ヒーロー	ヒーローものなんだ俺はいつでも話せます！
寒気	晩ご飯もそこそこ食べれたし、寒気もないし、治ってきました
落ち込み	どうも落ち込み気味なので話して元気もらいました
元気	どうも落ち込み気味なので話して元気もらいました|体調がまだあまりよくないから、なにか元気が出そうなご飯が食べたい
感謝	しおんちゃんに感謝です
ぼろぼろ	明日ぼろぼろに言われそうだから
拒否	2回デート行って、付き合ってみる？とかいって拒否されたみたい
どん	どんだけ上から目線だ！
目線	どんだけ上から目線だ！
内定	さきちゃん内定取れてるよって伝えたよ
多田	多田マンション 3階
マンション	多田マンション 3階|マンションのお金は払い込んで
ラウンジ	今日はしおんちゃんとラウンジいたら
イケメン	他の社員に、イケメン二人組！っていわれたよ|イケメンだ！
ゃんおきてますかっ	さきちゃんおきてますかっ
話半分	母親の話は話半分に聞いといてください
事案	それは事案ではありませんか！
辛抱	それまでの辛抱
発表	明日のバンド発表緊張
bellesalle	http://www.bellesalle.co.jp/room/sankaku/
room	http://www.bellesalle.co.jp/room/sankaku/
sankaku	http://www.bellesalle.co.jp/room/sankaku/
黒	黒ミッキーマフラーで乗り切ります|よかった黒なら置いてるのかな
ミッキー	黒ミッキーマフラーで乗り切ります
マフラー	黒ミッキーマフラーで乗り切ります
成功	大成功だったと思います！
完成	盛り上がってたし一番完成度高かったし！|システム丸投げされて、来週水曜までに完成だからヘビーかも
居心地	自社の人俺一人だから居心地悪いー
順位	あら順位というより得点大事です！
得点	あら順位というより得点大事です！
恵方	恵方巻きだ！
ふん	うん！45ふんくらいかな
籐	今日は数籐さんと飲んで帰ります！
ディスニーランド	ディスニーランドがあります
工事	道工事してて|各停は工事中だから一個しかないよー
夏見	夏見北でーす、先でとまりまーすぅ
北	夏見北でーす、先でとまりまーすぅ|あ、北いくー
停留所	ううん、停留所の10めーとる先くらいでとまったよ！
団地	ちなみにうちは団地入口か桜ヶ丘です
入口	ちなみにうちは団地入口か桜ヶ丘です|南口改札でて、斜め左の入口から地下へ
電波	どうも電波悪い。今日はねときましょー
のど	のどは大丈夫？
トイレ	トイレちょっといきます|俺もトイレいきます|トイレ行ってた！|ファミマのトイレまでいってきます|トイレ治ったかも！
目標	目標も達成できていい休日でした
達成	目標も達成できていい休日でした
手袋	昨日手袋忘れてたよ
精算	精算所というのがきました
初期	初期費用めちゃくちゃ安い
費用	初期費用めちゃくちゃ安い
めちゃくちゃ	初期費用めちゃくちゃ安い|言ってることがめちゃくちゃすぎて笑った！|めちゃくちゃ暑い！|かっぱ寿司で食べよー、と思ったらめちゃくちゃ混んでた！
いとう	いとうちゃんが彼女
やすみ	明日行けばやすみ！
契約	あさって契約にいってくるね|契約書は貰ったのであとは親父に書いてもらって
部屋	部屋もどるまでまちますっ|畳の部屋の照明がない|フローリング2部屋はledにして|畳の部屋はどんなのがいいかな！|部屋は個室、しかない感じかな？
郵送	郵送して、鍵もらってです！|保険証も連絡して、また郵送してもらいます！
引っ越し	引っ越し作業いぷしましょ！|引っ越し, http://www.amazon.co.jp/registry/wishlist/VBMAP29JAKSH/ref=cm_sw_r_li_awwlo_0nx6ub1937AWS|ふむふむ、引っ越しの用意しなきゃだけどどう腰が重い
作業	引っ越し作業いぷしましょ！
ぷしましょ	引っ越し作業いぷしましょ！
京成	京成船橋がテレビでてる！
くすり	胸が痛いのでくすりのみます
スト	アマゾンの欲しいものりスト
,	引っ越し, http://www.amazon.co.jp/registry/wishlist/VBMAP29JAKSH/ref=cm_sw_r_li_awwlo_0nx6ub1937AWS|0.341　G　VS2　3EX H&C　90,330円　GIA鑑定書付 ○|0.346　F　SI1　3EX H&C　89,570円　○|俺も2,3分遅れてつきそう！
amazon	引っ越し, http://www.amazon.co.jp/registry/wishlist/VBMAP29JAKSH/ref=cm_sw_r_li_awwlo_0nx6ub1937AWS
registry	引っ越し, http://www.amazon.co.jp/registry/wishlist/VBMAP29JAKSH/ref=cm_sw_r_li_awwlo_0nx6ub1937AWS
wishlist	引っ越し, http://www.amazon.co.jp/registry/wishlist/VBMAP29JAKSH/ref=cm_sw_r_li_awwlo_0nx6ub1937AWS
VBMAP	引っ越し, http://www.amazon.co.jp/registry/wishlist/VBMAP29JAKSH/ref=cm_sw_r_li_awwlo_0nx6ub1937AWS
JAKSH	引っ越し, http://www.amazon.co.jp/registry/wishlist/VBMAP29JAKSH/ref=cm_sw_r_li_awwlo_0nx6ub1937AWS
ref	引っ越し, http://www.amazon.co.jp/registry/wishlist/VBMAP29JAKSH/ref=cm_sw_r_li_awwlo_0nx6ub1937AWS
sw	引っ越し, http://www.amazon.co.jp/registry/wishlist/VBMAP29JAKSH/ref=cm_sw_r_li_awwlo_0nx6ub1937AWS
r	引っ越し, http://www.amazon.co.jp/registry/wishlist/VBMAP29JAKSH/ref=cm_sw_r_li_awwlo_0nx6ub1937AWS
li	引っ越し, http://www.amazon.co.jp/registry/wishlist/VBMAP29JAKSH/ref=cm_sw_r_li_awwlo_0nx6ub1937AWS
awwlo	引っ越し, http://www.amazon.co.jp/registry/wishlist/VBMAP29JAKSH/ref=cm_sw_r_li_awwlo_0nx6ub1937AWS
nx	引っ越し, http://www.amazon.co.jp/registry/wishlist/VBMAP29JAKSH/ref=cm_sw_r_li_awwlo_0nx6ub1937AWS
ub	引っ越し, http://www.amazon.co.jp/registry/wishlist/VBMAP29JAKSH/ref=cm_sw_r_li_awwlo_0nx6ub1937AWS
AWS	引っ越し, http://www.amazon.co.jp/registry/wishlist/VBMAP29JAKSH/ref=cm_sw_r_li_awwlo_0nx6ub1937AWS
歯	こんにちは！歯が痛いよおおおお|歯が全体的に痛くなってきたよ|今は薬効いてるみたいで歯そんな痛くないけど
神経痛	うん、神経痛っぽい
ロキソニン	さきちゃん、ロキソニン飲んだから歯痛どころか|ロキソニンは秘薬ですね、、!!|ロキソニン飲んでもきいてない
歯痛	さきちゃん、ロキソニン飲んだから歯痛どころか
痛み	あごの痛みすらひいてきたよ！
秘薬	ロキソニンは秘薬ですね、、!!
ゼリー	昼はゼリーだけだったけど、夜はカップめん食べれました
カップめん	昼はゼリーだけだったけど、夜はカップめん食べれました
薬効	今は薬効いてるみたいで歯そんな痛くないけど
歯医者	あさって歯医者いきます|こんにちは！歯医者きてます|歯医者は3時からー。いすと机はきたけどまだルーターがきてない|俺寝てて歯医者いけなかった
家具	なんの家具もないから|家具そろえて綺麗にしてからきてもらおう！|家具屋の階まできました
おん	今日は帰社してしおんちゃんいたんだけど
虫歯	なんだかんだで虫歯みたい
炎症	今日は炎症起こしてるから来週治療するって
治療	今日は炎症起こしてるから来週治療するって
葛飾	東京都葛飾区西新小岩1丁目4-1
西新小岩	東京都葛飾区西新小岩1丁目4-1
グランエスポアール	グランエスポアール502
用意	ふむふむ、引っ越しの用意しなきゃだけどどう腰が重い
おめかし	おお、おめかしばっちり！
サイゼリヤ	今サイゼリヤでご飯食べてるから|ふむふむ、とはいえなんかサイゼリヤで高級なのは飲む気がしないw
ワイン	白ワインのグラスを飲んでます！
イタリアン	おしゃれなイタリアンなので大人になった気分です！
裏	裏メニュー
メニュー	裏メニュー
高級	ふむふむ、とはいえなんかサイゼリヤで高級なのは飲む気がしないw
買い出し	さきちゃん買い出し気をつけてね
畳	畳の部屋の照明がない|畳の部屋はどんなのがいいかな！|新品の畳の匂いがします
照明	畳の部屋の照明がない
フローリング	フローリング2部屋はledにして
led	フローリング2部屋はledにして
電気	電気ガス水道おっけーです
ガス	電気ガス水道おっけーです
水道	電気ガス水道おっけーです
マラソン	名古屋マラソンやってるけどそちらは暖かそうだ
そちら	名古屋マラソンやってるけどそちらは暖かそうだ
北口	今日は北口すぐのルノアールって喫茶店で晩ご飯！|はい！北口改札でまってるね|北口いるよー|北口でいいよね|北口お願い|北口いたわけじゃないのかな|北口で待つよ！|10時50分ごろに北口でよろしいでしょうか？|北口まで？|北口迎えにいきましょうか！|そしたら北口いきますね|北口というか一回家帰るよ！|北口いくねー|着く頃連絡するね！北口であいましょ|はい！北口改札で|次平井だから、北口であいましょ|北口着いたらおしえてー|北口いきます！|北口改札いますね！
ルノアール	今日は北口すぐのルノアールって喫茶店で晩ご飯！|俺はルノアールで勉強中|ちょっとルノアールで株の雑誌読んで帰ります|おつかれさま！ルノアール朝ご飯|ルノアールでも行きますか！|いつごろ家着くかな？今ルノアールいるので|ルノアールいたけど帰る！|ルノアールおります！さきちゃん来る？|はい！ルノアールいます|もう少しルノアールで勉強して帰りますね
喫茶店	今日は北口すぐのルノアールって喫茶店で晩ご飯！|喫茶店で勉強してたから戻ります！
得	ご飯セットなら890円なのでお得かなって
ヴィアマンマ	ヴィアマンマってとこでパスタ食べたので帰ります！
きた	きたいたえさん？|きた！
メール	朝方親からメールきてたような...|一応親用のメールさきちゃんにも出しました|おつかれさま！メールするー
返信	返信しといた！
宅急便	おー、あとは宅急便で送ればいいだけかな？
.-.	あ、忘れてた.-.
行き	行きに振り込みます
新品	新品の畳の匂いがします
匂い	新品の畳の匂いがします
ゃんもちょうどいいかな	俺は50分新小岩くらいだからさきちゃんもちょうどいいかな？
家電	家電は何時とどくんだっけ？|家電かも？
郵便受け	郵便受けに配達票入ってないかな？
配達	郵便受けに配達票入ってないかな？
間隔	間隔調整で少しおくれてます
調整	間隔調整で少しおくれてます
番号	さきちゃん見知らぬ電話番号からかかってきたから|追跡番号てのはなくて、お問い合わせ送り状番号なら|お給料ふりこまれた！さきちゃんの口座番号と支店なんだろ？
コジマ	今からコジマがいくそうです！
忘れ物	忘れ物ないように|忘れ物はないと思う
お迎え	お迎えにあがります！|おつかれさま！お迎えにいきます|お迎えにいきます|終わったらお迎えにあがります|はやい！お迎えにあがります|お迎えにあがりますね|帰りますので45分くらいにお迎えお願いします|お迎えお願いします！
水	ゴミは水土でした|お水のおかわりもらってた|水が出てくるのに5分以上かかる|水受け取りお願いします|水が届くはずです|水、ホットマット、掃除機、ゴミ箱|水とその他で届きそうだけど、全部きたかな？
土	ゴミは水土でした
ゃんどこいってんだろ	さきちゃんどこいってんだろ？
出席	出席になってしまいますね！|しおんしとすどうし出席取り付けました！
材料	材料あったっけ？
肉	肉がいいです！
ょにいこ	いっさょにいこ！
サミット	サミットむかうね|俺もサミットいくー|サミット？
願	いこう！駅までむかえお願いっ
いす	歯医者は3時からー。いすと机はきたけどまだルーターがきてない
机	歯医者は3時からー。いすと机はきたけどまだルーターがきてない|机がくさい？？
ルーター	歯医者は3時からー。いすと机はきたけどまだルーターがきてない
炎	炎丸にでも行きたいなあ|炎丸で晩ごはん|炎丸いきたいけど
丸	炎丸にでも行きたいなあ|炎丸で晩ごはん|炎丸いきたいけど|システム丸投げされて、来週水曜までに完成だからヘビーかも
ミラコスタ	ミラコスタすごくきれい！
行動	あら、さきちゃん行動力ある！
つたや	つたやのまえにいます
見込み	帰りはたぶん9時くらいの見込みです！
まつよ	南口でまつよ！|改札でまつよ！
ソファ	ソファベッドでいいかな
ベッド	ソファベッドでいいかな
掛け布団	掛け布団だけでも
松江	松江病院まで歩いてきたので一緒にかえろっ|松江小のほうにとめてます
船堀	1時から借りたからたぶん船堀1時半とかにつくかな！
品川	品川53だから遅くなる|品川53分乗って帰ります！
コクーンビル	コクーンビルの隣が職場！
何分	新小岩何分だろー？|新小岩何分だろ|新小岩何分だろ？|何分着くらいだろ？
nhk	nhk対応です
みち	よりみち？
ぶん	せぶんかな！|せぶんおります
ぁみまいなかった	ふぁみまいなかった！
コメダ	コメダでご飯たべてます|コメダ混んでる
和牛	今日は和牛のステーキにしよう
ステーキ	今日は和牛のステーキにしよう
ダイソー	ダイソーの前いるね
イオン	イオンいってたべようかな！
花月	花月の隣だとそば屋か中華かな？
そば	花月の隣だとそば屋か中華かな？
中華	花月の隣だとそば屋か中華かな？
トムズカレー	トムズカレーと同じなんだ。そこのラーメン辛そう
かわり	お水のおかわりもらってた
ストーカー	ストーカーっぽいのでたいさんします！
いっしょ	ご飯はいっしょに食べよ！|おそめの運転練習中。晩ご飯いっしょに食べよう！
ららぽーと	今ららぽーといるから俺の方が遅くなるかな
次新	次新小岩！
小岩	次新小岩！|はい！今新小岩駅出たから
誤算	うれしい誤算だね！
バームクーヘン	バームクーヘン届かなかったよー
りす	8時15分ごろかえりす！
アイス	アイス買ってかえるー
かに	かにばりずむ！
浅草橋	やった！今浅草橋だから
祝い	今日は現場終わり祝いに外で食べよう！
os	os xです！
x	os xです！
洗濯	うん！洗濯物ほしときます！|洗濯物ほしとツタヤとゴミだしはしたよー|洗濯物取り込んでおいて！|あ、洗濯物ほしてない...
ぎにはかえれますっ	おつかれさま！7時過ぎにはかえれますっ
マック	マックでポテト買おうとしたらあげはじめたので
ポテト	マックでポテト買おうとしたらあげはじめたので
夜勤	夜勤がんばってね|夜勤おつかれさま|夜勤明けか
%	10%offできる|ふむふむ、6%キープできましたね|6%切ったらか...！
off	10%offできる
help	help！
みなみ	みなみぐちいく！|みなみ！|みなみすなまち！
ぐち	みなみぐちいく！
出発	もう出発しました！とうろうの並食べきりました
ろう	もう出発しました！とうろうの並食べきりました
通夜	通夜終わりました！
皆	皆でご飯食べて今日は会場で泊まり|葬式は滞りなく終わって、皆で銭湯いきました
会場	皆でご飯食べて今日は会場で泊まり
泊まり	皆でご飯食べて今日は会場で泊まり
開封	開封前もおねがい！
型番	型番なんだろ？
旧型	ううん、旧型だと思うけどやっぱりいいですね！
葬式	葬式は滞りなく終わって、皆で銭湯いきました
銭湯	葬式は滞りなく終わって、皆で銭湯いきました
浴衣	浴衣みせて
飛行機	1230の飛行機で羽田には1400くらいにつく
羽田	1230の飛行機で羽田には1400くらいにつく
アイスノン	アイスノンてきなものと
タイオンケイ	タイオンケイがほしい
熱	熱は今はさがって、夜使えるように冷凍庫いれてるから|足いたと熱少しあったから
冷凍庫	熱は今はさがって、夜使えるように冷凍庫いれてるから
...？	480円の半額が290円...？って思って新小岩のホームから撮っちゃった|薬忘れてる...？|指輪はめてこなかったかなと思うんだけど、家にあるかな...？
バス停	バス停つきました|あ、そういうバス停があるんだ|バス停いくよー
ps	ps4やってた！
狩人	狩人何回死んだかわかりません
敵	敵が鬼畜すぎます
鬼畜	敵が鬼畜すぎます
都合	うーん、月曜夜とか？さきちゃんの都合いい時間で渡してもらえばいいかな
献花	献花したので帰ります
大作	大作だ
パルコ	パルコ側の改札いるね|パルコじゃなくてマルイだったね
電灯	前の電灯のしたにいます！
ぱるこ	ぱるこ！
アルカキット	アルカキットの逆！|アルカキットいく？
マルイ	パルコじゃなくてマルイだったね|じゃマルイむかいます！
VS	0.341　G　VS2　3EX H&C　90,330円　GIA鑑定書付 ○
EX	0.341　G　VS2　3EX H&C　90,330円　GIA鑑定書付 ○|0.346　F　SI1　3EX H&C　89,570円　○
H	0.341　G　VS2　3EX H&C　90,330円　GIA鑑定書付 ○|0.346　F　SI1　3EX H&C　89,570円　○
&	0.341　G　VS2　3EX H&C　90,330円　GIA鑑定書付 ○|0.346　F　SI1　3EX H&C　89,570円　○
GIA	0.341　G　VS2　3EX H&C　90,330円　GIA鑑定書付 ○
鑑定	0.341　G　VS2　3EX H&C　90,330円　GIA鑑定書付 ○
書付	0.341　G　VS2　3EX H&C　90,330円　GIA鑑定書付 ○
F	0.346　F　SI1　3EX H&C　89,570円　○
SI	0.346　F　SI1　3EX H&C　89,570円　○
かも	これとかも|かも！|あさって両親がうち来るかもなので
枠	これに枠代8万とかかな？|一番安い枠で3万みたい|枠が6万くらいかな？
御徒	御徒町がお買い得みたいで参考が
お買い得	御徒町がお買い得みたいで参考が
ryu	http://www.ryu-tsu.co.jp/kakaku.html#diamond
tsu	http://www.ryu-tsu.co.jp/kakaku.html#diamond
kakaku	http://www.ryu-tsu.co.jp/kakaku.html#diamond
#	http://www.ryu-tsu.co.jp/kakaku.html#diamond|http://hlo.tohotheater.jp/net/schedule/029/TNPI2000J01.do#showing_schedule
diamond	http://www.ryu-tsu.co.jp/kakaku.html#diamond
MD	ここのMD-1
takara	http://www.takara-kiho.co.jp/design_ring/design_ring.html
kiho	http://www.takara-kiho.co.jp/design_ring/design_ring.html
design	http://www.takara-kiho.co.jp/design_ring/design_ring.html
ring	http://www.takara-kiho.co.jp/design_ring/design_ring.html
花火	花火大会は市川市側で見よう！
大会	花火大会は市川市側で見よう！
江戸川	江戸川区より空いてて屋台も出てるみたいだし
屋台	江戸川区より空いてて屋台も出てるみたいだし
大州	大州防災公園がいいみたい
防災	大州防災公園がいいみたい
公園	大州防災公園がいいみたい
ミニオンズ	ミニオンズ錦糸町で9時か13時からみれる！
hlo	http://hlo.tohotheater.jp/net/schedule/029/TNPI2000J01.do#showing_schedule
tohotheater	http://hlo.tohotheater.jp/net/schedule/029/TNPI2000J01.do#showing_schedule
schedule	http://hlo.tohotheater.jp/net/schedule/029/TNPI2000J01.do#showing_schedule
TNPI	http://hlo.tohotheater.jp/net/schedule/029/TNPI2000J01.do#showing_schedule
J	http://hlo.tohotheater.jp/net/schedule/029/TNPI2000J01.do#showing_schedule
showing	http://hlo.tohotheater.jp/net/schedule/029/TNPI2000J01.do#showing_schedule
ハッピー	さきちゃんハッピーアワーいってみたい
アワー	さきちゃんハッピーアワーいってみたい
文字	文字入力してたよー？
入力	文字入力してたよー？|こんにちは！ピアリー入力おわってるから
マンガ	マンガ喫茶で勤務表作成してる！
作成	マンガ喫茶で勤務表作成してる！
ぐでますっ	すぐでますっ
始発	始発で帰ります
出迎え	帰ってシャワー浴びたので寝ます！お出迎えできないけど一緒にねよー
しら	しゅーらるーしらない
内側	改札の内側いるね
コーナー	2階の時計コーナー移動します
移動	2階の時計コーナー移動します
杜	千の杜6人じゃ仕切りないレストラン席になるて言われた
仕切り	千の杜6人じゃ仕切りないレストラン席になるて言われた
レストラン	千の杜6人じゃ仕切りないレストラン席になるて言われた
二見浦	二見浦駅って遠いのかな？
読書	えんまるで晩ごはん兼読書してるけど
ise	http://www.ise-kamimura.jp
kamimura	http://www.ise-kamimura.jp
キャンセル	キャンセルしましょう|キャンセルはしておくから、さきちゃん予約してみてー|きくよしキャンセルしたよー|ありゃ、キャンセルの電話今しちゃった！
いき	だいきあんとだいきは違う？
個室	部屋は個室、しかない感じかな？
料理	料理も予約しちゃおう！|6000円の懐石料理でいいかなあ|コース変えて、料理出すタイミングで声かける感じにしました|タイ料理！
きく	きくよしキャンセルしたよー
懐石	6000円の懐石料理でいいかなあ
ちり	これで顔合わせもばっちりだね
部	10時からの部？
ゃんち	あるとしたらご飯食べる前10時にさきちゃんち行って
大喜	タクシー2台で大喜庵へ
庵	タクシー2台で大喜庵へ
フェア	12日フェアでいいとこあるかな！
上野	上野あたりであれば！
指輪	指輪取りに行く前にいけたらなーって|それか指輪取りに行ったあと、夕方くらいから横浜とか|指輪わすれたー|指輪はめてこなかったかなと思うんだけど、家にあるかな...？
横浜	それか指輪取りに行ったあと、夕方くらいから横浜とか
オムライス	昼がオムライスにゆで卵たべたからたまご以外かな！
卵	昼がオムライスにゆで卵たべたからたまご以外かな！
ツタヤ	洗濯物ほしとツタヤとゴミだしはしたよー
うえの	かえります！うえの
区役所	もう区役所いったかな？婚約届もらっておいてほしいなー|土曜日は区役所も区民事務所もやってなさそう？
婚約	もう区役所いったかな？婚約届もらっておいてほしいなー
戸籍	あ、でも俺が戸籍謄本もらいに行くとき一緒にもらえばいいや|あとで船橋に戸籍謄本とりいく！
謄本	あ、でも俺が戸籍謄本もらいに行くとき一緒にもらえばいいや|あとで船橋に戸籍謄本とりいく！
冷凍	冷凍のパスタでも大丈夫です！
うり	きうりは食べたい
いく	えんまるいく！
ミスド	ミスド前いきますっ
タイミング	コース変えて、料理出すタイミングで声かける感じにしました
不遇	しおんちゃんの不遇話きいてます
着付け	駅→着付けのとこ→さきちゃんちと回ってもらうかと
お茶	うん、お茶飲むだけなんだけど|俺もお茶しに行く！|お茶してます！|俺が寄るならお茶でも出すよっていったの
自己	自己紹介的なものをそこですることになるのかな
流れ	どんな流れにしようか悩みます！
一之木	三重県 伊勢市一之木3丁目 15-1 美容室アリア
美容	三重県 伊勢市一之木3丁目 15-1 美容室アリア|俺の方が早そうだったら美容院までむかえにいくね
アリア	三重県 伊勢市一之木3丁目 15-1 美容室アリア
akb	akbカフェとガンダムカフェは隣みたいだね！
ガンダムカフェ	akbカフェとガンダムカフェは隣みたいだね！
勘違い	勘違いしてたよー
チーム	チームメンバーが一人もいなくて仕事が全く進まない状態...
土産	いいえ！土産話が聞ければ
区民	土曜日は区役所も区民事務所もやってなさそう？
商店	まだかかりそうなので商店街の|商店街にあるとこね
書林	なんとか書林？て本屋さんいるね
本屋	なんとか書林？て本屋さんいるね|本屋いくよ！|本屋のほうみます|いってらっしゃい！ちょっと秋葉の本屋寄ってかえる！|ちょっと本屋寄って帰るねー
活動	今日は活動的ですね
心配	ううむ...心配ですね|余計な心配をかけてしまいそうなので|ふむふむ　結構心配ですね
コンタクト	コンタクトにしよう！
ファミマ	ついた！ファミマ前にいるね|ファミマ前かな？|45分くらいにファミマ前いきます|ファミマで買い物しよー|ファミマのトイレまでいってきます
がれ	みんなとご飯食べて帰るながれかな？
ーーー	にがかったーーー
集まり	ラーメン食べて、バンド部の集まりいってきます！
天	天やの日で天丼390円だからそっちでもいいかも？
天丼	天やの日で天丼390円だからそっちでもいいかも？
そっち	天やの日で天丼390円だからそっちでもいいかも？|そっちいってきます！|そっちまでいくんだ|そっちいってたんだー|そっちいくねー|そっちいくよー|改札違ったらそっちいきますね|そっちいきますね！
役所	明日午前休もらったから一緒に役所いこう|役所行って年金について聞いたら|年金の件は役所の土屋さんだか土田さんだか、男の人に聞いたよー
何時	何時までー？
ルミ	ルミエールうろつきます
エール	ルミエールうろつきます|お寿司とエールどっちでもよいです！
書店	書店います
ケバブ	ご飯はケバブでいいかなあと思ってる|ケバブかって帰るんや！昨日と同じ11時頃帰宅予定です
ぴりから	ぴりから！
ゲバブ	ゲバブこうて帰る！
両国	俺両国でご飯食べるから同じくらいかも！
e	e03のとこいます！
ょうてんがいいきたい	しょうてんがいいきたい
す	今日はしおんしとすどうしに飲み誘われたので|しおんしとすどうしがくるかも|しおんしとすどうしと飲むことになりました！|しおんしとすどうしは渋谷いって朝までとか|しおんしとすどうしと飲んできます！|しおんしとすどうしと飲んでたよー
ぎるかそれくらいになるかと	今仕事終わってから行くから、帰りは12時すぎるかそれくらいになるかと
布団	布団出しといてください
となり	となりの大学でご飯たべます！
大学	となりの大学でご飯たべます！
食堂	食堂で牛丼食べてみたけど、味は別にふつー
牛	食堂で牛丼食べてみたけど、味は別にふつー|がっつり食べるぞー！なら牛角のクーポンがよさそうだけど
味	食堂で牛丼食べてみたけど、味は別にふつー
ふつー	食堂で牛丼食べてみたけど、味は別にふつー
学生	混んでないけど学生の接客だから
接客	混んでないけど学生の接客だから
レシート	むかえいく！スーツのレシートあるかな？
ツリー	夕方頃からスカイツリーいこう
目処	今日はだいたい10時目処であがります！
NTT	NTTにお金払ってなくて回線とめられたのか
回線	NTTにお金払ってなくて回線とめられたのか
半蔵門線	50分に錦糸町の半蔵門線の改札おねがい！
jr	jrとは違うよー
斜め	南口改札でて、斜め左の入口から地下へ
地下	南口改札でて、斜め左の入口から地下へ
社長	社長らとご飯たべてます
秋葉	秋葉まだいる？|ちょっと秋葉に技術書見にいって帰ります|いってらっしゃい！ちょっと秋葉の本屋寄ってかえる！|秋葉のブックカフェで本よんで帰りますねー|おつかれさま！秋葉いたからかえるねー|秋葉で中古ノートパソコン買おうか悩んでます|秋葉だから12時すぎかと|個別相談終わった！秋葉でスマホ見て帰るねー|6時秋葉となりました、今帰ってるよー
クレカ	クレカがくるので家で待機してます！　
技術	ちょっと秋葉に技術書見にいって帰ります
書見	ちょっと秋葉に技術書見にいって帰ります
株	ちょっとルノアールで株の雑誌読んで帰ります
まれ	おつかれさまれ
てれ	駅行るので着く頃おしえてれ！
空間	自由空間いるのです|自由空間いるから着くころ教えて！
飯田橋	俺は今飯田橋|飯田橋のハロワ無能職員に当たっちゃったから
レンタカー	レンタカー借りれたらレンタカーでどこかいこうか
ゃんまだぎんこういる	さきちゃんまだぎんこういるー？
タブレット	もうそろそろあがる予定だけど、タブレット届いてるか見てもらいたいな！
我々	やった！我々の勝利だ！
勝利	やった！我々の勝利だ！
年末年始	年末年始はがんばりましょう
異色	よねとしおんしの異色コンビでこれから飲みます
コンビ	よねとしおんしの異色コンビでこれから飲みます
こうか	よねんちいこうかと思ったけど帰った！|えんまるいこうか！
端末	新しい端末のほう設定しました！
バックナンバー	バックナンバーようつべできいてる
JINS	錦糸町のJINS！
ニュース	痛いニュースデビューもしたよー
デビュー	痛いニュースデビューもしたよー
マリック	マリック見ました！麻雀して帰ります
TSUTAYA	TSUTAYAいきたい
カステラ	カステラ届いてたよー
会計	お会計！
スプラトゥーン	スプラトゥーンやっとく！
豚	豚骨ラーメンたべたい！
ぷめん	かっぷめん！
ゅう	お風呂わかしちゅう！|かえりちゅう|ちょっと残業ちゅう
麺	麺以外！
高架	高架下きました
信号	信号待ち
小声	お寿司食べよう（小声）
金額	金額はまた考えなきゃね！
電池	電池きれそう！
ばん	ばんちゃん
ろか	えんまる、ぼかろか、うめきち、とんこいわ、ヴあまんま、はいから、
ヴ	えんまる、ぼかろか、うめきち、とんこいわ、ヴあまんま、はいから、
テンション	寒くてテンション低い
ゃんまだいたらいくね	さきちゃんまだいたらいくね
盛り上がり	そこそこ盛り上がりは良かったけど
パフォーマンス	どうも自分のパフォーマンスが出せなかった
谷	今四谷なのです
市ヶ谷	次は市ヶ谷市ヶ谷
優先	優先席付近では
付近	優先席付近では
フォン	もー場フォンさいれんともーど
さい	もー場フォンさいれんともーど
不良	しおん氏体調不良で帰りますー
多め	おお、休み多め
ライトニング	さすがライトニングさん
いくよ	本屋いくよ！
米	それくらいで！米かおー|お米がないよ
かお	それくらいで！米かおー
松原	松原さすが！
渋谷	しおんしとすどうしは渋谷いって朝までとか
彼ら	彼らは困りますねえ
バンコクオーキッド	バンコクオーキッド [食べログ] - バンコクオーキッド
[	バンコクオーキッド [食べログ] - バンコクオーキッド
]	バンコクオーキッド [食べログ] - バンコクオーキッド
タイ	タイ料理！
ダッシュ	定時ダッシュ予定だから、新小岩南口6:45位だと思う
クーポン	がっつり食べるぞー！なら牛角のクーポンがよさそうだけど
安	そうでもなければ安々かなあ
悩み	もうちょっとやってこうか悩み中。
ょ	じょーすたー！
マルク	マルクさん！
小雨	小雨だったら大丈夫かも！
弓道	弓道部のみなみなさま|弓道具は買えた？
みなさま	弓道部のみなみなさま
華やか	華やかですねえ
同士	女同士！
封筒	さきちゃん封筒ありがとー。申し込み書出せました！|金券入れる封筒が欲しいなあ
申し込み	さきちゃん封筒ありがとー。申し込み書出せました！|ジムの申し込みいってきますねー|申し込み中
コンセント	新幹線にコンセントあるはず！
指定	指定なんだ
先入	今お茶の水だけど先入ってて
処理	あ、処理書き忘れてた
てい	うんかくてい
コーヒークーヘン	コーヒークーヘンは確かにおいしそう
確か	コーヒークーヘンは確かにおいしそう
戻り	こんにちは！手戻りが多々発生してるので
靴	靴までとは
葉	今秋葉だから8時前にはつくかも|今秋葉出たので30分くらいかなあ|今秋葉だから10分後くらいに錦糸町つきます！
南	南までいくね
びさむなのでおうち	びさむなのでおうち待機
味噌汁	うん、味噌汁も飲む|松屋は持ち帰り味噌汁つかないからー
滑り出し	おお、順調な滑り出し
気配	一向に終わる気配がないよーよー
代表	今日日本代表のサッカー録っておいて
食欲	忙しくてあまり食欲沸かないけど
上がり	10時上がりの11時頃になりそうです！
タルト	タルト食べていいよ
どら	どらえもん！
スーパーレア	スーパーレアですね
悲壮	悲壮感漂う
いくら	はい！いくらだった？
値段	結構いいお値段
明け	明けでお出かけはきびしいから
!!!	12時にはかえる!!!
合流	合流します
茅場	だけどまだ茅場町
ょっとおつまみつまむていどでいいかな	ちょっとおつまみつまむていどでいいかな
gw	gw休むためにがんばります
若者	若者向きではなさそう！
本格	本格的だ
まんじゅう	かりんとうまんじゅうおいしそう
同僚	同僚と麻雀やってます|同僚に飲みのお誘い受けたのでいってきますー
ships	shipsいきます
ユニバース	なのユニバースいきます
ジャーナル	ジャーナルスタンダードいきます
スタンダード	ジャーナルスタンダードいきます
クッターナ	はい！クッターナで待ち合わせよー
待ち合わせ	はい！クッターナで待ち合わせよー
ハロワ	飯田橋のハロワ無能職員に当たっちゃったから
無能	飯田橋のハロワ無能職員に当たっちゃったから
職員	飯田橋のハロワ無能職員に当たっちゃったから
墨田	墨田のほういってくるー
祝日	ほー、祝日だからすいてるのかな
プロジェクト	今日は急遽プロジェクトの送別会が入ったので
お誘い	同僚に飲みのお誘い受けたのでいってきますー
ハンター	ハンター買ったから読んでね！
浅草	浅草でのんでます
録画	サッカーやるみたいだから録画しておいて
最短	最短8日
松屋	松屋の前ついた！|松屋は持ち帰り味噌汁つかないからー
ゆきこ	ひろゆき、ゆきこ、みこ
みこ	ひろゆき、ゆきこ、みこ
漢字	だけど、ゆきこの漢字がわからぬ
住所	友人らは住所わかるから
ピアリー	こんにちは！ピアリー入力おわってるから
印刷	印刷しちゃってください
"	"ディヴィニティ：オリジナル・シン　エンハンスド・エディション_20160622002653" を YouTube で見る - https://youtu.be/T-ugBPbFcLw|"FF4　愛のテーマ　ピアノ" を YouTube で見る - https://youtu.be/I2fGXP9RLes
ディヴィニティ	"ディヴィニティ：オリジナル・シン　エンハンスド・エディション_20160622002653" を YouTube で見る - https://youtu.be/T-ugBPbFcLw
オリジナル	"ディヴィニティ：オリジナル・シン　エンハンスド・エディション_20160622002653" を YouTube で見る - https://youtu.be/T-ugBPbFcLw
シン	"ディヴィニティ：オリジナル・シン　エンハンスド・エディション_20160622002653" を YouTube で見る - https://youtu.be/T-ugBPbFcLw
エンハンスド・エディション	"ディヴィニティ：オリジナル・シン　エンハンスド・エディション_20160622002653" を YouTube で見る - https://youtu.be/T-ugBPbFcLw
https	"ディヴィニティ：オリジナル・シン　エンハンスド・エディション_20160622002653" を YouTube で見る - https://youtu.be/T-ugBPbFcLw|"FF4　愛のテーマ　ピアノ" を YouTube で見る - https://youtu.be/I2fGXP9RLes|https://youtu.be/8OQaCVMF1zo|https://dev.to
T	"ディヴィニティ：オリジナル・シン　エンハンスド・エディション_20160622002653" を YouTube で見る - https://youtu.be/T-ugBPbFcLw
ugBPbFcLw	"ディヴィニティ：オリジナル・シン　エンハンスド・エディション_20160622002653" を YouTube で見る - https://youtu.be/T-ugBPbFcLw
退職	退職届にワード使いたいから
moopa	南口のmoopa寄って帰ります
夏バテ	夏バテ！
切手	切手こうたよー
挨拶	会社への挨拶も終わったよー
...！	おお、仕事が早い...！|おわった...！圧倒的に帰る!!|6%切ったらか...！
あたり	このあたりだけかも通り雨かな
通り雨	このあたりだけかも通り雨かな
お昼	遅めのお昼だね
FF	"FF4　愛のテーマ　ピアノ" を YouTube で見る - https://youtu.be/I2fGXP9RLes
愛	"FF4　愛のテーマ　ピアノ" を YouTube で見る - https://youtu.be/I2fGXP9RLes
テーマ	"FF4　愛のテーマ　ピアノ" を YouTube で見る - https://youtu.be/I2fGXP9RLes
ピアノ	"FF4　愛のテーマ　ピアノ" を YouTube で見る - https://youtu.be/I2fGXP9RLes
I	"FF4　愛のテーマ　ピアノ" を YouTube で見る - https://youtu.be/I2fGXP9RLes
fGXP	"FF4　愛のテーマ　ピアノ" を YouTube で見る - https://youtu.be/I2fGXP9RLes
RLes	"FF4　愛のテーマ　ピアノ" を YouTube で見る - https://youtu.be/I2fGXP9RLes
ひろ	まひろくんしかわからない
新橋	新橋|JR新橋駅の烏森口に19:20でお願いします！
君津	29分君津行きで帰りますね！
リクルート	こんにちは！リクルートのビルすごい
店内	店内入る？
財布	お財布だけでいいかな
ブック	あきばのブックカフェきたー|秋葉のブックカフェで本よんで帰りますねー
中番	中番の時間くらいからいけばいいんじゃないかなあ
迷宮	迷宮ラブソング！
ラブソング	迷宮ラブソング！
かつお	うん、かつおぶし選んでる
朱	この朱赤でいいかなあ
赤	この朱赤でいいかなあ|赤めずらしい
ぎめしてます	結婚式の曲ぎめしてます
入場	入場:one love 退場:gutsはいい感じな気がする
one	入場:one love 退場:gutsはいい感じな気がする
love	入場:one love 退場:gutsはいい感じな気がする
退場	入場:one love 退場:gutsはいい感じな気がする
guts	入場:one love 退場:gutsはいい感じな気がする
散財	近くていいね！かわいすぎて散財してしまいそうだ
ボーナス	ボーナスもらえないってさー
商談	商談とやらいってきますね！帰るのは8時半とかかな
わん	わんこ！
こ	わんこ！
金杉	今から金杉出るので10時半くらいかと！
ケンタッキー	ケンタッキーかいにいこうかなー
ケンタ	ケンタの前いるね
見学	職場見学とやらいってきましたー
雷	雷もすごかったー
ゲーセン	ちょっとゲーセンで遊んでかえります！|おはよ！ゲーセンおります
Suica	はい！Suicaはみてないなあ
晩	おそめの運転練習中。晩ご飯いっしょに食べよう！
くら	6時くらあになります
直し	錦糸町で裾直しとかしてたから今から帰るね！
嵐	嵐iTunesにないんよ
iTunes	嵐iTunesにないんよ
しっぷ	しっぷすいない|しっぷすまえのイス座ってます
イス	しっぷすまえのイス座ってます|窓側のイス座ってますね
暇	こんにちは！今のところ暇です
久々	久々に働くと疲れるー|久々残業
解放	さきちゃんが解放された！
金券	金券入れる封筒が欲しいなあ
ハイパーアクティブ	ハイパーアクティブさきちゃんですね！
SSR	SSR！
★★★★★★	★★★★★★
切符	新小岩で切符かう
内宮	内宮今出たので、ららぱーく5時とかかなあ
ら	内宮今出たので、ららぱーく5時とかかなあ|ららぱーく後17:45までバス無いから|今からららぱーく向かいます|ららぱーくから大湊行くバスが17:45までありません|ららぱーく|ららぱーくまできてもらえると|らーめん食べて帰りました！
ゃんのほうどうじゃろ	さきちゃんのほうどうじゃろ？
湊	ららぱーくから大湊行くバスが17:45までありません
くま	ららぱーくまできてもらえると
タオル	あとバスタオル白色なかったので、さきちゃんちあるかなあ
白色	あとバスタオル白色なかったので、さきちゃんちあるかなあ
ゃんちあるかなあ	あとバスタオル白色なかったので、さきちゃんちあるかなあ
人数	こりゃ大人数ですなあ
完了	こんにちは！払い込み完了しました
オフィシャル	オフィシャルショップだけでもいこう！
ペペロンチーノ	ペペロンチーノあげてください
本	秋葉のブックカフェで本よんで帰りますねー|あきばで本買ってかえりますねー|欲しい本がなかったので帰る
あそこ	あそこは有楽町です！ヨドバシの上だよー|あそこ潰れちゃったのかあ
有楽町	あそこは有楽町です！ヨドバシの上だよー
ヨドバシ	あそこは有楽町です！ヨドバシの上だよー
直前	直前になっちゃったけど、おーひよねと飲みいってくるね
システム	システム丸投げされて、来週水曜までに完成だからヘビーかも
ヘビー	システム丸投げされて、来週水曜までに完成だからヘビーかも
圧倒的	おわった...！圧倒的に帰る!!
OQaCVMF	https://youtu.be/8OQaCVMF1zo
zo	https://youtu.be/8OQaCVMF1zo
美味	お弁当美味でした！|おいしかったよ！漬け物も美味でした
日暮里	日暮里のとこ？
思	結構降ってたらやだなーって思ただけなので
階	家具屋の階まできました
ぱなのかな	鍵家におきっぱなのかな
ょなすんでご	じょなすんでご飯たべてきますね！
飯	じょなすんでご飯たべてきますね！
ょなすん	じょなすん！
奥	奥の左側おるね|おつかれさま！2階の奥います
左側	奥の左側おるね
華麗	華麗に帰るんじゃ
スタート	いいスタートですね
鍋	鍋いいね！
華	華禅あったような気がするけど、どこかわからぬ
禅	華禅あったような気がするけど、どこかわからぬ
りかん	ぼったくりかんがあったな！と
動作	動作確認はしといたほうがいいかもね
高円寺	とはいえ、仕事終わりで高円寺までいくのもなあと
漬け	おいしかったよ！漬け物も美味でした
追跡	追跡番号てのはなくて、お問い合わせ送り状番号なら
問い合わせ	追跡番号てのはなくて、お問い合わせ送り状番号なら
送り状	追跡番号てのはなくて、お問い合わせ送り状番号なら
後楽園	後楽園駅の改札にしよう
春日	春日通り方面改札います！
方面	春日通り方面改札います！
質素	こっちすごく質素
リリース	リリースは明日だよー
kirby	http://www.kirby.jp/25th/
th	http://www.kirby.jp/25th/
カービィ	カービィのサイトかわいい！
あらあら	あらあら
成長	さきちゃんの成長をひしひしと感じます
ぉぉ	おおぉぉ
様子	いったんおうちで様子みてからいきましょか|ゆうやくんの様子はどうでしたか？
hiygia	http://hiygia.mydns.jp:8000/bot/
mydns	http://hiygia.mydns.jp:8000/bot/|http://bonojojo.mydns.jp/bot/saki
bot	http://hiygia.mydns.jp:8000/bot/|http://bonojojo.mydns.jp/bot/saki
しょ	しょうち！
かこ	一緒にかこー
換気	うち換気のため窓あけてます！
持ち帰り	松屋は持ち帰り味噌汁つかないからー
平井	次平井だから、北口であいましょ|俺次平井！
ゅちゅあんな	ちゅちゅあんな前にいます
ーーーー	かえれないーーーー
受け取り	水受け取りお願いします
熱海	熱海！
シフト	おー、いい感じのシフト
振り込み	振り込みはお願い
打診	正社員の打診がありました
免許	免許の更新いてきます
火災	火災保険の申し込みしててもうすぐ帰ります
保険	火災保険の申し込みしててもうすぐ帰ります|保険証も連絡して、また郵送してもらいます！
書類	書類選考2社通って、合わせて面接5社になりました
選考	書類選考2社通って、合わせて面接5社になりました
和やか	なんか終始和やかではあったんだけど、45分で終わるという
半目	1時間半目安で45分だったからねー
ゴールデン	ゴールデン街という新宿のいい感じのとこでのんでます！
源泉	源泉徴収票お願いします！
徴収	源泉徴収票お願いします！
手続き	いろいろ手続きに時間かかったから今日は休みもらいました！
花見	親父からも明日姉らと一緒に花見しよういわれて
体重	体重もあまり増減なく安定してきましたね
増減	体重もあまり増減なく安定してきましたね
パスポート	今日パスポート受取＋ご飯で船橋駅8時に
受取	今日パスポート受取＋ご飯で船橋駅8時に
秋葉原	今秋葉原だからもう少しまってて
中	中でいいです。そのままいこう
チェック	先輩の厳しいチェックですね！
早番	おつかれさま！早番だからあと少し
予感	帰れない予感
ょお	よかったなあ　　　りょお
爽やか	いってらっしゃい！いい天気で爽やかでよかった
常連	常連だね！
ランチ	6/11ランチみたいです
すき焼き	すき焼きかしゃぶしゃぶどっちがいいですか！
飲み物	使ってる！飲み物がほしいかなあ
図書館	図書館で勉強してます。8時ごろに帰ります|おつかれさまー。図書館で勉強してますね|おつかれさま！図書館いたので俺も帰りますねー
関係	それとは関係なく書った本読みに外出ました！
書	それとは関係なく書った本読みに外出ました！
本読み	それとは関係なく書った本読みに外出ました！
兄さん	帰りましたが、お兄さんとお話し中のようですが俺がいること悟られないようお願いします！
お話し	帰りましたが、お兄さんとお話し中のようですが俺がいること悟られないようお願いします！
余計	余計な心配をかけてしまいそうなので
個別	個別相談終わった！秋葉でスマホ見て帰るねー
相談	個別相談終わった！秋葉でスマホ見て帰るねー
窓側	窓側のイス座ってますね
西口	はい！西口にお願いします|中央西口と西口があるからね
車両	一番前の車両の近くの階段降りたらすぐだよー
階段	一番前の車両の近くの階段降りたらすぐだよー|階段のとこで待ってるね！|そしたらこっちの階段おりたとこにしよう
年金	役所行って年金について聞いたら|年金の件は役所の土屋さんだか土田さんだか、男の人に聞いたよー
全額	俺とさきちゃんは全額免除対象になれるらしい
免除	俺とさきちゃんは全額免除対象になれるらしい
対象	俺とさきちゃんは全額免除対象になれるらしい
*	16000*2払わないでいいって
おかず	白ご飯はあるから、おかずだけでも買い行こうか？
件	年金の件は役所の土屋さんだか土田さんだか、男の人に聞いたよー
土屋	年金の件は役所の土屋さんだか土田さんだか、男の人に聞いたよー
土田	年金の件は役所の土屋さんだか土田さんだか、男の人に聞いたよー
bonojojo	http://bonojojo.mydns.jp/bot/saki
saki	http://bonojojo.mydns.jp/bot/saki
ハヤシ	ハヤシ食べよー
三脚	スマホの三脚かなー
同い年	おーひ彼女は同い年だった
津	津出身みたい|津と松阪の間とか
パンフレット	パンフレットに乗るレベルですね😄
椅子	三階の窓の椅子に座ってるね😃
クーラー	クーラーつけっぱなしでした😅
ライ	涼しいから結果オーライ
大勢	大勢！さきちゃん、ゆうすけさん、両親、こうすけさんち、まさしさん
両親	大勢！さきちゃん、ゆうすけさん、両親、こうすけさんち、まさしさん|あさって両親がうち来るかもなので
まさし	大勢！さきちゃん、ゆうすけさん、両親、こうすけさんち、まさしさん
一命	一命をとりとめた
お話	少しお話しませんか|11時とかにお話したい
かっぱ	かっぱ寿司で食べよー、と思ったらめちゃくちゃ混んでた！
ザバス	ザバス買いにいくので10分後くらいに！
アキバ	アキバにパソコン見に行ってお勉強
友達	見たことあるお友達
チェックイン	チェックイン18:30
変更	↑で変更しました！
交換	交換しましょー
手料理	さきちゃんの手料理が恋しい！
鳥羽	7時半に出て鳥羽駅に12時半に着く予定ですよー
まんが	まんがきっさ？
チケット	チケットと充電器はもちまして
千疋	千疋屋はまだ空いてなさそうなので考えなきゃ、、、
開店	8時開店で買えた！新幹線も乗れて定刻通り
定刻	8時開店で買えた！新幹線も乗れて定刻通り
play	さっきのplay asisで買ったカードだけど、
asis	さっきのplay asisで買ったカードだけど、
ます	ます！
鹿児島	17日鹿児島台風かも
お納め	お納めください
キープ	ふむふむ、6%キープできましたね
検査	なんにせよ、検査は行ってみよー
気候	今日は気候が良くて気持ちいいああー
JR	JR新橋駅の烏森口に19:20でお願いします！
烏森	JR新橋駅の烏森口に19:20でお願いします！
女医	女医さんは少ないんだね
海	海ほたる通ってアウトレットいきます！
ほた	海ほたる通ってアウトレットいきます！
dev	https://dev.to
to	https://dev.to
チャイタレー	チャイタレーならぶ
ぐ	そういえば今日らぐ届く！
スタジオアリス	スタジオアリスの前にいるねー
号車	4号車|3号車のります！
ステーション	イベントステーションの前にいるー
今新	はい！今新小岩駅出たから
Amazon	Amazon届いたかなー？
やまと	やまとの運ちゃんから電話きてたから届けられなかったのかなとか思いまして
運	やまとの運ちゃんから電話きてたから届けられなかったのかなとか思いまして
ホット	水、ホットマット、掃除機、ゴミ箱
マット	水、ホットマット、掃除機、ゴミ箱
ゴミ箱	水、ホットマット、掃除機、ゴミ箱
その他	水とその他で届きそうだけど、全部きたかな？
数藤	数藤氏宅にもうすぐ着きます～
宅	数藤氏宅にもうすぐ着きます～
粗大ごみ	粗大ごみお願い！
ぉぉぉぉ	ふおぉぉぉぉ！
バル	また前のバルテックの人と面談一緒だったから
クリスマス	なんかクリスマスプレゼントとかどうとか
丸ノ内線	丸ノ内線はエスカレーターあがってすぐだった気がする
標識	上の標識見てれば大丈夫さ！
ピーク	そっか、結構今日ピークかもね😢
ペルソナ	昨日ペルソナ5買ったんだー！
見覚え	あれ、見覚えのないスタンプ
急行	急行も混みんでて特急も売り切れ
売り切れ	急行も混みんでて特急も売り切れ
居間	寝るまで居間にいましょう
Zerbino	Zerbinoみます
フルーツパーラー	さきちゃん終わったらフルーツパーラーいこ
家出	家出ます
UNKNOWN	UNKNOWN CONTENT
CONTENT	UNKNOWN CONTENT
キング	キングダム読みながら帰りますー
キタ	うん、珍しく休日に電話キタ
改善	改善の余地がありますね...
余地	改善の余地がありますね...
読み	いい読みでした
レコーダー	レコーダーとテレビは5000円になったよ～